Puzzle,Solution,Execution Time,Zeros,Guesses,Backtracks
207408609100090007000070000370602098600000001580719063800524006005060800906837102,237458619158296347469173285371642598694385721582719463813524976725961834946837152,0.09614200005307794,41,3081,3040
257000439300000006160000082400603005003912800090040010601537908000821000085090320,257168439348259176169374582412683795573912864896745213621537948934821657785496321,0.02148330002091825,42,136,94
000374089008100400470086003030000048507640391090000052820067005003900200000231074,216374589358129467479586123132795648587642391694813752821467935743958216965231874,0.07401050004409626,42,2625,2583
208369407600154003500278006004000800305080702780010045400000008052000630060843020,218369457679154283543278196124537869395486712786912345431625978852791634967843521,0.04108270001597703,41,1033,992
468051739100000600000670012084030060315406007097080040000910074900000300753064291,468251739172349658539678412284137965315496827697582143826913574941725386753864291,0.03801129997009411,39,764,725
146000598207000304389000127400060002600872001002010900000643000060589040930020085,146237598257198364389456127413965872695872431872314956528643719761589243934721685,0.02843800000846386,41,455,414
147903268000000000309070105410060089603000401095080630000534000500692003030010020,147953268258146397369278145412365789683729451795481632821534976574692813936817524,0.18231379997450858,43,7309,7266
040096580000007009300208174010000948800000007934000060481605003600700000073140020,147396582258417639369258174716532948825964317934871265481625793692783451573149826,0.04229509999277070,45,1054,1009
307165209200394006000278000012000860803000402490080035600000008784000523030020040,347165289258394716169278354512439867873651492496782135621543978784916523935827641,0.03110309998737648,42,481,439
100238005200040006400679008002090600508020901690000052700000004835402179046010520,167238495289145736453679218312594687578326941694781352721953864835462179946817523,0.06054320000112057,41,1813,1772
100458002200109003009237100000684000600395008890010064021000730940000021760020085,136458972257169843489237156312684597674395218895712364521846739948573621763921485,0.03700099996058270,41,899,858
340080019100040002009107300000623000603794105790010036401000603935000278870000041,347286519158349762269157384514623897683794125792815436421978653935461278876532941,0.03125060000456870,40,598,558
125030489300109007000000000201070804700491006090080070512000748907000602860725013,125637489348159267679248135251376894783491526496582371512963748937814652864725913,0.02223709999816492,40,124,84
037140560108006004460570008010000290904007685080000430590730006601009003073650910,237148569158296374469573128316485297924317685785962431592731846641829753873654912,0.02546699997037649,39,268,229
030000208248100076069270003610380000000000000000092014900043860350007921806000030,137456298248139576569278143612384759493715682785692314921543867354867921876921435,0.07915609999326989,45,2904,2859
130200450000300008809070013460105000003080100000704032320040906600003000085009041,136298457247351698859476213462135879573982164918764532321547986694813725785629341,0.12962090002838522,46,5167,5121
107246500000010400000078020302400956080000070794005208020890000003050000005762801,137246589258319467469578123312487956586921374794635218621893745873154692945762831,0.08681290003005415,45,2981,2936
250160800160000702009008040400600908020080030905003001040700600702000014006014027,254167893168349752379258146413625978627981435985473261541732689732896514896514327,0.13464920001570135,46,5062,5016
147306002250100000300200145410508607005062800820703504500800769670900000984605001,147356982258149376369287145413598627795462813826713594531824769672931458984675231,0.06952720001572743,37,2589,2552
200347096360000000009802000410500907080090010703006048000903800000000079940685001,258347196364159782179862435412538967586794213793216548621973854835421679947685321,0.23756670003058389,46,10057,10011
347009028150000600200100435410685003005093800890417006700900584530000900986004012,347569128158342679269178435412685793675293841893417256721936584534821967986754312,0.02823190001072362,37,230,193
057208406400150070300060001210504000004000100000306049800020004040071003502603910,157238496468159372329467851213594687694782135785316249831925764946871523572643918,0.06549680000171065,45,2214,2169
006357928000000704300084005412500097083970050597800013700098006000000209004723581,146357928258619734379284165412536897683971452597842613725198346831465279964723581,0.02554259996395558,38,362,324
103207408460090037070030010300504009084912370090080040901653704800000001006000900,153267498468195237279438516312574869684912375597386142921653784835749621746821953,0.03562899999087676,42,840,798
206000308350000061190060027400503009002896100003070200600732004700010005839040712,246157398357289461198364527461523879572896143983471256615732984724918635839645712,0.03290380001999438,41,684,643
100098254408000000059400607300845000080000030000132008801009460000000705975360001,137698254468527319259413687312845976584976132796132548821759463643281795975364821,0.11137909995159134,45,4514,4469
207459601000000000069128470000296000050814020890070064600000008720080016980030042,237459681148367259569128473471296835356814927892573164613742598724985316985631742,0.17407720000483096,42,7583,7541
107254089392160400000070200200000070500802134900000020000030800635980700809627013,167254389392168457458379261213546978576892134984713625721435896635981742849627513,0.02708019997226074,41,455,414
100368009400259008080010050012080490504000802690724031900506003000000000046832910,157368249463259178289417356312685497574193862698724531921546783835971624746832915,0.02069699997082353,41,99,58
000629540200084600400005102070000039602000407380000050703800005005910004046253000,137629548259184673468375192571462839692538417384791256713846925825917364946253781,0.05127100000390783,45,1597,1552
007269030000540700350108006520000047674900385890000012410605009000890200005724060,147269538268543791359178426521386947674912385893457612412635879736891254985724163,0.02009520004503429,40,101,61
026154780108000304479080251200060008500709003090020040000070000000948000015030490,326154789158297364479386251231465978584719623697823145942571836763948512815632497,0.15831610001623631,44,7006,6962
246010097150200006309407105000040000470895061000020000501906803760300009938050072,246518397157239486389467125612743958473895261895621734521976843764382519938154672,0.02935460000298917,40,550,510
046030097002109008700000100060095073400802009590360010004000005900501300830040720,146238597352179468789654132261495873473812659598367214614723985927581346835946721,0.02254060003906488,45,217,172
002140860408250000170300004010000076605702341090000028520900007806570000007820630,352147869468259713179368254213485976685792341794613528521936487836574192947821635,0.03046490001725033,42,621,579
006280700207351009800400031010000096503008147070000023300700068704832005005140300,136289754247351689859467231412573896593628147678914523321795468764832915985146372,0.01980890001868829,41,84,43
007348900300169007400050003070030080503000704690000021920504038706801405045090170,217348956358169247469257813172436589583912764694785321921574638736821495845693172,0.02155220002168790,40,153,113
150347620000068005000200040412070060675009203983010070000800030000034006830926750,159347628247168395368295147412573869675489213983612574796851432521734986834926751,0.08030840003630146,41,3038,2997
017259640000060000500748003030080060805906702290000034000315000150090076004627300,317259648428163597569748123731482965845936712296571834672315489153894276984627351,0.08354259998304769,42,3232,3190
004167290000340500100008034080003006702000401900700080610500009003081000095674100,354167298268349517179258634581423976732896451946715382617532849423981765895674123,0.03744230000302196,45,912,867
100234007040000030308000401421060398580020064009000200002040500030516070960872043,196234857247158639358697421421765398583921764679483215712349586834516972965872143,0.02835139998933300,41,486,445
207108309300629007060307050012000690500080001800090004021030780734805926980000013,247158369358629147169347852412573698593486271876291534621934785734815926985762413,0.02210010000271723,39,206,167
100058963000009057039600200370400008482036095690700001013500800000003019800014372,147258963268349157539671284371495628482136795695782431913527846724863519856914372,0.01898539997637272,40,46,6
230050097070060050581409236100000005860295041700804003000080000007521800900746002,236158497479362158581479236124637985863295741795814623612983574347521869958746312,0.06105519999982789,41,2076,2035
200300489450000070009400005600200104092060830803001002900005700030000058586007001,217356489458129673369478215675283194192564837843791562921835746734612958586947321,0.13192119996529073,46,5601,5555
300498002008153400009000310120800006485070031790300005001000980002739100900681003,317498652268153479549267318123845796485976231796312845631524987852739164974681523,0.02756610000506043,41,438,397
257010469160020075400060008300206007082090640000154000000030000043070250670000013,257318469168429375439567128314286597582793641796154832921635784843971256675842913,0.13258500001393259,44,5676,5632
200040005060159040450000013100000004580090062600512008001923500030671020006485700,217348695368159247459267813172836954583794162694512378741923586835671429926485731,0.09839090000605211,42,4045,4003
100357009050249070070000040501000706680070054400615008003060800014732960000891000,146357289358249671279186543531428796682973154497615328923564817814732965765891432,0.05101220001233742,42,1657,1615
300248679000050830080000200104500007738490026506700003010000700000010460800627391,351248679267159834489376215124563987738491526596782143612934758973815462845627391,0.05492309998953715,42,1808,1766
107246509050793060009050200302000906510389042700000001021000390000030000970625018,137246589258793164469158273382417956516389742794562831621874395845931627973625418,0.03707940003369004,41,907,866
206458709500030008080167020103000806060000010700306002601985204000040000870623051,216458739547239168389167425123574896465892317798316542631985274952741683874623951,0.02788239996880293,41,457,416
246100380100300007009060005530704000004080700000506013400030900900001004085002631,246157389158349267379268145532714896614983752897526413421635978963871524785492631,0.06618249998427927,46,2294,2248
160237089000149000009050300200306007690070021754010963002000600030504070800961005,165237489328149756479658312281396547693475821754812963512783694936524178847961235,0.03681900002993643,41,899,858
047103560100000009360070021510704096403865102000010000600357004000080000075902610,247193568158426739369578421512734896493865172786219345621357984934681257875942613,0.03165080002509058,42,613,571
086203479200100308300070052402500006063780900708400003600040097800900605075801234,186253479257194368349678152412539786563782941798416523621345897834927615975861234,0.01976729999296367,38,54,16
204571089000340200570068400300050006485600071700080004820036700000810900903725068,234571689168349257579268413312457896485692371796183524821936745657814932943725168,0.02099429996451363,39,127,88
307189500000035740000000810580000976090000050673000024014000000026850000005764201,347189562168235749259476813581342976492617358673598124714923685926851437835764291,0.05143270001281053,45,1627,1582
108000307560000081070080040300407008006592700005010400801935604900040005054020130,148256397569374281273189546312467958486592713795813462821935674937641825654728139,0.09801590000279248,43,3924,3881
106045789200007304400390001002780000584609000009530000700820005800006403903051872,136245789298167354457398621312784596584619237679532148741823965825976413963451872,0.02593050000723451,40,363,323
051400367308000004470500000137080050000604000090050872000002045700000601946005720,251498367368127594479536218137289456582674139694351872813762945725943681946815723,0.04120820004027337,45,1146,1101
240050019108209304509104602000040000480965031000010000003507400900030007756090123,247356819168279354539184672371842965482965731695713248813527496924631587756498123,0.04555859998799860,41,1393,1352
038000760170306089690000035200080001307592608009010200000935000900761004760020013,538149762172356489694278135256487391317592648849613257421935876983761524765824913,0.02093870000680909,41,140,99
100040009370000054409000701210050076500781002000462000040975030001020900700814005,165247389378196254429538761214359876536781492987462513642975138851623947793814625,0.05112509999889880,44,1644,1600
307251608000009042209000310410000006573096001890000007601000870000008059905742103,347251698158369742269487315412573986573896421896124537621935874734618259985742163,0.03348179999738932,41,741,700
107302508008090100300581004010639080070000030893000621620050047700010002005274800,147362598258497163369581274412639785576128439893745621621853947784916352935274816,0.02971500001149252,41,571,530
320648019008030400409050208210000084580000093704803102030000020600080005070926040,327648519158239467469157238213795684586412793794863152931574826642381975875926341,0.06332740001380444,42,2232,2190
200375004090080050408000103530000087620897031700503002045000620800942005900651008,216375894397184256458269173531426987624897531789513462145738629863942715972651348,0.02808979997644201,40,511,471
300297105000036070079000320512300004783040012694700008027000890000024050900873201,346297185258136479179458326512389764783645912694712538427561893831924657965873241,0.07260600000154227,39,2610,2571
402509103075238460000070000050080090713090845809000307520040086900020004600701002,482569173175238469396174258254387691713692845869415327521943786937826514648751932,0.02405080001335591,41,251,210
190000057248070169300169004002513800000496000000782000700050008034000670905807402,196248357248375169357169284472513896583496721619782543721654938834921675965837412,0.02225740003632382,41,214,173
140000078360040091200000006401539607002060900000712000500623009026000430937804162,145396278368247591279185346481539627752468913693712854514623789826971435937854162,0.02259110001614317,40,195,155
200138400040059100000007035500000689080090070963000004610800000004670010005912006,256138497347259168198467235571324689482596371963781524619843752824675913735912846,0.27297559997532517,46,12703,12657
140200806050160403009080002400308000003070900000502008900020500601053040805004067,147239856258167493369485712412398675583671924796542138934726581671853249825914367,0.06586299999617040,46,2399,2353
201400708300000652600250041006308009030592800008706004800970023700000985903800107,251463798374189652689257341126348579437592816598716234865971423712634985943825167,0.07579370000166818,40,2816,2776
417208659508109307000050000100624008000010000005803200700000006840090075956781432,417238659528169347369457821173624598284915763695873214731542986842396175956781432,0.04509630001848564,40,1173,1133
150200009268009007079000125500700000610000094000003006431000970900800463700004012,154237689268159347379468125592746831613582794847913256431625978925871463786394512,0.11552300001494586,45,4823,4778
347158209000009008000060450100000095280000031590000002068030000700600000902874316,347158269625349178819267453173482695284596731596713842468931527731625984952874316,0.07897059997776523,45,3034,2989
007036590200197400360050000401800059680900731503600042830010000700369200006084310,147236598258197463369458127471823659682945731593671842834512976715369284926784315,0.02350060001481324,39,263,224
401279305200145009070060020105000908380000041700010003000050000043927510007681400,461279385238145679579368124125734968386592741794816253612453897843927516957681432,0.03949080000165850,42,1005,963
103248506400109003020060080731000965860000047900070001300000008007836400058914730,173248596486159273529367184731482965862591347945673821394725618217836459658914732,0.02882720000343397,40,487,447
038469510100000002570030068300000009002301700007285400700853004040716020856000173,238469517169578342574132968315647289482391756697285431721853694943716825856924173,0.02107839996460825,40,146,106
050070289407200006238000000002065040600809003080120500000000832700001604849030010,156374289497218356238956471312765948675849123984123567561497832723581694849632715,0.05017489998135716,45,1460,1415
147230096250100003009000802000080740700624138000090260004000607830500004976840051,147238596258169473369457812612385749795624138483791265524913687831576924976842351,0.02559939998900518,40,356,316
050046079468000003300100000004710060100482007080069200000004005900000482840920010,251346879468297153379158624524713968196482537783569241612834795935671482847925316,0.06619670003419742,46,2403,2357
036010790100000006200346001002060900600105007790020064000000000940601025863752419,436518792158279346279346581312467958684195237795823164521984673947631825863752419,0.07812760001979768,42,2927,2885
016350000408109000300400108180000693503206417760000825600700304905801000047630000,216358749478169532359427168182574693593286417764913825621795384935841276847632951,0.02733010001247749,40,444,404
340010067100368009000407000071030690400659001000070000004080900825000713930020084,349215867157368249268497135571834692482659371693172458714583926825946713936721584,0.04320190002908930,44,1283,1239
350040079169000003072300005001430000000712000000098400500004780800000394940060052,358146279169257843472389615281435967694712538735698421513924786826571394947863152,0.03664410003693774,46,925,879
100207689000008305009405100721300006893600004654900003007506900000003507500709431,145237689276198345389465172721354896893671254654982713437516928912843567568729431,0.02191820001462474,40,176,136
150600239208009057070054008000430000002175384000890000010023006905008043830900725,154687239268319457379254618581436972692175384743892561417523896925768143836941725,0.03955510002560914,40,990,950
137400809048000005500000014310024900006301582980065400600000098053000006894600203,137456829248139675569278314315824967476391582982765431621543798753982146894617253,0.06233049998991191,41,2204,2163
105279604008030500760845021000050000406000702500408003620080035850000017903502806,135279684248136579769845321312657498486391752597428163621784935854963217973512846,0.10319300001719967,40,4272,4232
400507109000290054500030076010002900206000705008400020950040002620051000804309001,432567189167298354589134276315672948246983715798415623951746832623851497874329561,0.03915769996820018,45,1003,958
102305709005080100000167000040050070517020394800000001920030017730816052600702008,162345789475289163389167245243951876517628394896473521928534617734816952651792438,0.02202400000533089,41,152,111
150273089070060010629000357012000970500000006700194002001946700000712000200308001,154273689378569214629481357412635978593827146786194532831946725945712863267358491,0.05636450002202764,42,1887,1845
100205608000069037369000500403520000582090046601780000914000300000013064800902105,147235698258169437369478521473526819582391746691784253914657382725813964836942175,0.04349569999612868,41,1308,1267
104257806007080050509006000310500008470028319690700002701005000006040030903871605,134257896267189453589436271312594768475628319698713542721365984856942137943871625,0.05563509999774396,40,1822,1782
200356009058020360309000205400000003576030428890000056001000500700815002900642001,247356819158429367369187245412568973576931428893274156621793584734815692985642731,0.34537410002667457,42,16380,16338
130245000200080030908006210400607009860390027700804003304002980500070040690418000,136245798247189536958736214413627859865391427729854163374562981581973642692418375,0.06663379998644814,41,2558,2517
147300529000009006360200107000090800570812604000040200620900708000001002834600951,147368529258179436369254187412596873573812694986743215621935748795481362834627951,0.02598669996950775,42,408,366
341206598200105007570040026003080700700409001800010004132060875000000000904837602,341276598268195437579348126413682759726459381895713264132964875687521943954837612,0.04858579998835921,40,1460,1420
408030107000479000070080040014658730050000060900020004000542000742000356090763020,468235197123479685579186243214658739357914862986327514631542978742891356895763421,0.17366160004166886,44,7938,7894
205040609060050040079080150124060978000000000800010004030694020542000796080725030,215347689368159247479286153124563978693478512857912364731694825542831796986725431,0.02753349998965859,42,445,403
100230097260009040080460021500070804000000000708090003420013080030700019970046005,154238697267159348389467521592371864613584972748692153425913786836725419971846235,0.04267749999416992,45,1069,1024
407030809560070034039060750300020008000000000600847001010684090943000286050392010,427135869568279134139468752371526948284913675695847321712684593943751286856392417,0.11109530000248924,42,4588,4546
240167305300420070090380000000000807837200956000000103010830000600910080980756201,248167395351429678796385412125693847837241956469578123512834769673912584984756231,0.04892309999559075,42,1479,1437
200469008140005090000080240000040809486000523705030000021090000050700061600351002,237469158148275396569183247312546879486917523795832614821694735953728461674351982,0.04848959995433688,45,1477,1432
350000079060050040409070105210587096500603002800104003000040000731962584900030001,352418679167259348489376125213587496574693812896124753625841937731962584948735261,0.04061069997260347,41,1088,1047
340200708007108034509430102130004905400300200790002603203940806004506079950700401,341265798627198534589437162132674985468359217795812643273941856814526379956783421,0.02043670002603903,36,106,70
400000578000000009309080014104702095200403001790805302610050403900000000857000006,461239578528174639379586214134762895285493761796815342612957483943628157857341926,0.11976749997120351,45,4997,4952
310209048050167030000080000123040987600000002905000403700020004542000396896030721,317259648458167239269483175123645987674398512985712463731926854542871396896534721,0.03348480002023280,40,742,702
230000018050030090400070005360000049000000000584601327719843562603705904040962070,236459718157238496498176235361527849972384651584691327719843562623715984845962173,0.02576560003217310,39,356,317
350109076060070040400030009010763080000000000597000463821050634905426807700080002,358149276169275348472638159214763985683594721597812463821957634935426817746381592,0.02947990002576262,41,542,501
050001089000389406400076120210400008000000000800003074021930007608712000940800010,356241789172389456489576123213457698794628531865193274521934867638712945947865312,0.04341540002496913,45,1256,1211
310209048050167030000080000100040007000308000985702463701926804002000300806030701,317259648458167239269483175123645987674398512985712463731926854542871396896534721,0.02758870000252500,42,459,417
200500837050307004309080050581000003000106000700000192010020309900803010837001005,246519837158367924379284651581972463492136578763458192614725389925843716837691245,0.12313980003818870,45,5157,5112
358000179160357082000090000280030096000702000637010524800523007000000000705189203,358246179169357482472891635281435796594762318637918524816523947923674851745189263,0.02407079999102280,41,283,242
057190048100000007480005000301002760500030002092700103000200075900000004730049620,257196348163428597489375216341852769576931482892764153614283975925617834738549621,0.06692589999875054,46,2329,2283
030000050208169307079030180010706090500010002607000403901070508700805001060321070,136487259258169347479532186312746895584913762697258413921674538743895621865321974,0.01991770003223792,42,69,27
360209080100456903400003560013504000704390006096807000800001640600748302940605010,365279481178456923429183567213564879784392156596817234837921645651748392942635718,0.02261859999271110,38,213,175
040200019200091600160480000501600090400070003090005201000032086005760004830004020,347256819258391647169487352571623498482179563693845271714532986925768134836914725,0.13759569998364896,46,5854,5808
005207093130400006279060000312500000500000007000004325000040569900001082750809400,465217893138495276279368154312576948584932617697184325821743569943651782756829431,0.06487949995789677,45,2308,2263
207301080050629004369004000410000006600000001900000037000400798700218060030905402,247351689158629374369784125412837956673592841985146237521463798794218563836975412,0.20284579996950924,45,9288,9243
000317069160092003009000000410700008503904607700008032000000300900830046630549000,254317869168492573379685124412763958583924617796158432841276395925831746637549281,0.92330489994492382,45,44805,44760
200037080350269000000080006612300005403000702700002643900020000000941028020750001,246137589358269174179485236612374895483596712795812643931628457567941328824753961,0.09214809996774420,45,3503,3458
200137009050269070109080206610000095400000002790802043031020450000941000820050061,246137589358269174179485236612374895483596712795812643931628457567941328824753961,0.01978119998238981,41,83,42
145397268000125000209060501403602905500000006607000302050040020900010003830050014,145397268368125497279468531413672985582934176697581342751843629924716853836259714,0.10578179999720305,41,4281,4240
145397268300125007009060500410000085500000006007000300750040029900716003006050700,145397268368125497279468531413672985582934176697581342751843629924716853836259714,0.02971850003814325,43,580,537
340250000100469000009080005461000907502000306703000284900040600000831009000076042,346257891158469723279183465461328957582794316793615284917542638624831579835976142,0.03770649997750297,45,961,916
200570409350429000000036005103000500504000803009000102600740000000951067905083004,216578439357429681498136725123894576564217893789365142631742958842951367975683214,0.04906119999941438,45,1528,1483
150038090402197038300050100000304009508071204000502003800010900601729085970043020,157238496462197538389456172216384759538971264794562813823615947641729385975843621,0.04020370001671836,39,1043,1004
040368970160409003389100406002093008600080004008014009521900807970801005030745190,245368971167459283389172456412593768693287514758614329521936847974821635836745192,0.02490770001895726,36,315,279
028346570059000620674000831005060700400090002000010000000825000590030087063974210,128346579359187624674259831215463798436798152987512346741825963592631487863974215,0.05700159998377785,42,1890,1848
045687230360102054200000001000030000450020017000741000020374080930000075087915340,145687239368192754279453861712536498453829617896741523521374986934268175687915342,0.07100360002368689,41,2591,2550
047328000250100074300400000010004908780591632090006107900800000430600089076945000,147328596258169374369457821612734958784591632593286147921873465435612789876945213,0.03737919998820871,41,957,916
147239050250000000300504100421000087570900403893000015600703500730000000985621030,147239856258167349369584172421356987576918423893472615612743598734895261985621734,0.02220549999037758,40,170,130
350217096100349007400000001000605000580000074090824010010702050920000068837956142,358217496162349587479568321241675839586193274793824615614782953925431768837956142,0.02553210000041872,39,330,291
050149060000572000400060009132090475600050002590000036900624008700000003046735290,258149367369572184471368529132896475687453912594217836913624758725981643846735291,0.02593189995968714,42,336,294
457163800100000000000087030301500068002010400940008207010870000000000001006341572,457163829138295746269487135371524968682719453945638217513872694724956381896341572,0.36007659998722374,46,16855,16809
310560007067009203000000000170400005680215074900006028000000000809600450700024081,314562897567189243298347516172498635683215974945736128421853769839671452756924381,0.70947519998298958,46,34647,34601
250147039000259000000000000124070985500000002709000301000435000970020064845090123,256147839387259416491368257124673985538914672769582341612435798973821564845796123,0.02283380000153556,43,225,182
305040708060183090480060032040326080706891503000000000000738000000000000054612370,315249768267183495489567132541326987726891543938475216192738654673954821854612379,0.21630670002195984,44,9557,9513
358109002000030009270060030010000078002654300590000040020040057600080000900506813,358179462164235789279468135416392578782654391593817246821943657635781924947526813,0.03162820002762601,46,623,577
250367091000208000380050072000483000040709020708506103420000087900841006806902405,254367891167298354389154672512483769643719528798526143421635987975841236836972415,0.03583200002321973,39,863,824
200167009460352078170080026302548607000000000004010800000734000035020760040090030,258167349469352178173489526312548697586973412794216853621734985935821764847695231,0.64627029997063801,43,31268,31225
200040009360129057070080020502691704000000000706030802000050000047813260053060940,215347689368129457479586123582691734134278596796435812621954378947813265853762941,0.23737250000704080,43,10788,10745
302567108180293065560010072205836709000070000700040006000354000003080200050000010,342567198187293465569418372215836749436975821798142536621354987973681254854729613,0.08406220003962517,43,3152,3109
217300609400060007060000010000030894583904261000020573020000040900010002846700105,217348659458169327369257418172635894583974261694821573721583946935416782846792135,0.06583979999413714,43,2338,2295
351247689000030000279000314020706090500090008800010006010973040900050007780020031,351247689468139752279568314124786593536492178897315426612973845943851267785624931,0.22878999996464700,42,10502,10460
127300589000000002960008017040030050071205846080060070610004098000000005895600724,127346589458179632963528417246837951371295846589461273612754398734982165895613724,0.04504799999995157,42,1280,1238
010540682060007000400008000520300794800090005694005023000600008000800030786023040,317549682268137459459268317521386794873492165694715823132654978945871236786923541,0.08756529999664053,46,3445,3399
310248079240109086508306102420080057000090000060010020050704090004901700030060010,316248579247159386598376142421683957873592461965417823152734698684921735739865214,0.02446439996128902,42,285,243
140020690008100007000400015420581069081940002790236041000600074004700006970010520,147325698258169437369478215423581769681947352795236841812653974534792186976814523,0.06297349999658763,40,2197,2157
260308097470000026509070401120507069085090270796080135800000002900010008050020010,261348597478159326539276481124537869385691274796482135813965742942713658657824913,0.05249600001843646,40,1762,1722
360100240000000005540260079000395080836710502000628010420830057000000004780500360,367159248192487635548263179214395786836714592975628413421836957653971824789542361,0.03483729995787144,42,811,769
140258093300000007000407000400613008603974105000000000570040069000090000936825714,147258693358169247269437581425613978683974125791582436572341869814796352936825714,0.03586070000892505,43,811,768
160258790005000008000060045500601289917080506600503471000020067002000004830714950,164258793375149628289367145543671289917482536628593471491825367752936814836714952,0.03562129999045283,39,855,816
040316090100000003000279000300050009400000006090603050730040065002861700684537912,248316597179485623563279148316754289425198376897623451731942865952861734684537912,0.09354970004642382,43,3673,3630
200148360061000008080530007000607095926050801000801036090460002035000004700985610,257148369361279548489536127813627495926354871574891236198463752635712984742985613,0.03295090002939105,41,743,702
510037060602000009080090215100502000006080100000604003421060050900000301070940082,519237468642158739783496215134572896256389174897614523421863957968725341375941682,0.10897110000951216,46,4598,4552
100200500200009300380070162460900000502304906000006047624050093005600008008002001,146238579257169384389475162461927835572384916893516247624851793715693428938742651,0.47262129996670410,45,23134,23089
007040800400000001060108070312875649704060502000304000620030084043602150870010026,137246895458793261269158473312875649784961532596324718621537984943682157875419326,0.03099110000766814,40,636,596
460315892008000103030200457000503008304160500000807001010600985003000206850921734,467315892528479163139286457271593648384162579695847321712634985943758216856921734,0.02784669998800382,38,476,438
137420000208000007560000240000004038785263401000001072420000850903000006876190000,137426985248359167569718243612974538785263491394581672421637859953842716876195324,0.04358549998141825,43,1295,1252
105070902240189056680000017000508000070090040093060120021943860300000004060857030,135476982247189356689325417412538679876291543593764128721943865358612794964857231,0.02272810001159087,41,213,172
000654000108000403069000250310806079506392804080000020620080045790000081805961702,237654198158279463469138257312846579576392814984517326621783945793425681845961732,0.02388719998998567,39,270,231
000456000208109306069020750041000890500080003896000125600040008980000032703895604,137456289258179346469328751341562897572981463896734125615243978984617532723895614,0.02653190004639328,40,437,397
351248700200000000489060000100004390600902007098500002000030974000000006003796251,351248769276159483489367125125674398634982517798513642562831974917425836843796251,0.06425530003616586,45,2172,2127
246381050000000086098050400000723590000000000083465000004070930720000000030516274,246381759157249386398657412461723598572198643983465127614872935725934861839516274,0.04450029996223748,45,1336,1291
037568140100000005049020760002080500400296003080305070690040057700000004804937601,237568149168479235549123768312784596475296813986315472691842357723651984854937621,0.02764230000320822,41,524,483
006308700307109402400070006031080920004000500060504070200756009640801037070423050,126348795357169482498275316531687924784912563962534178213756849645891237879423651,0.03436069999588653,41,826,785
007004098058300001400100003010090037384000926790080040600005004800002510940800300,137524698258369471469178253512496837384751926796283145621935784873642519945817362,0.06176950002554804,45,2160,2115
100308005307169402400070006001000900784010563960504078000706000600891007870020051,126348795357169482498275316531687924784912563962534178213756849645891237879423651,0.02460720000090078,40,297,257
004201079100479003200000005040003008602040301700100020400000006900814007830506400,364251879158479263279368145541623798682947351793185624415732986926814537837596412,0.10708819999126717,46,4369,4323
300408005107269304098050120003000800589020413740000062600584007900601008070030040,326418795157269384498357126263145879589726413741893562612584937934671258875932641,0.02187410002807155,40,197,157
100309002209157403400060005004000800607090501980203047500000008740901056890030014,158349762269157483473862195314576829627498531985213647531624978742981356896735214,0.18915849999757484,41,8727,8686
300108009400239006200060003102000608643080915870000024500000007730801062960020031,356178249487239156219465783192354678643782915875916324521643897734891562968527431,0.06437999999616295,41,2367,2326
006005089307200000400067502200600908003408200904002006809520003000001405740900800,126345789357289164498167532271653948563498217984712356819524673632871495745936821,0.06893459998536855,45,2490,2445
008267050209300000000050108400503086590000034680704002704030000000001603030875200,148267359259318467367459128471523986592186734683794512714632895825941673936875241,0.03292899997904897,45,755,710
008235700300000002000000000210050098580000074700408001621040957935020486840596013,168235749359174862472689135214357698586912374793468521621843957935721486847596213,0.04570199997397140,40,1371,1331
047368520300000006060000030400937002700681004800205007002000800901402703674010295,147368529358129476269574138415937682723681954896245317532796841981452763674813295,0.02836739999474958,41,512,471
137460080200079060060000107300500006570000039900004001801000090040950008090042613,137465982258179364469283157312597846574618239986324571821736495643951728795842613,0.21604699996532872,45,10069,10024
501260070300000080009300024430002008100896003200400051710003400050000007060051902,541268379327149586689375124436512798175896243298437651712983465953624817864751932,0.05498089996399358,46,1829,1783
017050820200000007000000000100639008340785092790402036671020984030060010900871003,417356829269148357583297641125639478346785192798412536671523984832964715954871263,0.02664279995951802,41,433,392
157200380408300005000000207200005090503904702090800004601000000900003601075009423,157246389428397165369158247214735896583964712796821534631472958942583671875619423,0.20080910000251606,45,9095,9050
017463590300000004060000010620709053500010002000602000030000080945286731876931425,217463598358197264469825317621749853594318672783652149132574986945286731876931425,0.02748759998939931,39,479,440
158237400302009058070000000000004807534098026000002504020000000703005041945861200,158237469362149758479586312216354897534798126897612534621473985783925641945861273,0.02901550004025921,42,517,475
005060700601000304840309016100070009700198002980504037203706905008010600560030071,325461798691287354847359216152673849734198562986524137213746985478915623569832471,0.04460800002561882,40,1300,1260
158230060302000050070000002200004007530798026800600004600000080080000601040061273,158237469362149758479586312216354897534798126897612534621473985783925641945861273,0.29182869999203831,46,13909,13863
158070346300050007079000120200080009580792061700603008020105080000040000900827003,158279346362451897479368125216584739583792461794613258627135984831946572945827613,0.05715890001738444,43,1978,1935
407050306500060007060000080300090008870020014106040703040532070050080030903417602,417258396538169247269374185324791568875623914196845723641532879752986431983417652,0.14558820001548156,43,6279,6236
421300698608049070070000001107026005200570040504093007010000004305084010846700539,421357698658149273973268451137426985289571346564893127712935864395684712846712539,0.02059690002351999,39,117,78
317040596060050030000000000105493608630080019790010054070000060040725080800961002,317248596462159837589376421125493678634587219798612354271834965946725183853961742,0.10080370004288852,42,4081,4039
207608301000793000000000000402060809500020004706481503000509000804172905975040132,247658391158793246369214758412365879583927614796481523621539487834172965975846132,0.03852850000839680,41,1054,1013
150060049000070000200000006301090708004010900905627403800401007706902804549080231,157268349463179582298345176321594768674813925985627413832451697716932854549786231,0.03095610003219917,41,670,629
420136789608000050070000000246000507580690032193000806030000000902000010860915273,425136789618279354379458621246381597587694132193527846731842965952763418864915273,0.03919470001710579,41,1057,1016
420306089050040020360205047201408605680901072500000003010000050900104008846592731,427316589158749326369285147271438695683951472594627813712863954935174268846592731,0.02113920002011582,37,177,140
150247089000060000009000100502030907003090800804715603200000008708306501065070430,156247389387169254429583176512638947673492815894715623231954768748326591965871432,0.02531260001705959,43,334,291
040530691105009000300002000402075809000090000807610205000700003000900506986053020,248537691165849372379162458412375869653298714897614235521786943734921586986453127,0.39556990005075932,46,17957,17911
300246001000397000009000700201060508003070400594010673000504000805609107046080320,357246981168397254429158736271463598683975412594812673712534869835629147946781325,0.02093050000257790,43,141,98
300206001060090050409108706201060508003070400594010673000504000805609107046080320,357246981168397254429158736271463598683975412594812673712534869835629147946781325,0.02182720002019778,40,192,152
207000109108204000060000284502070403476023098803060701020000945704901000905000807,247386159158294376369517284512879463476123598893465721621738945784951632935642817,0.04237340000690892,40,1222,1182
010006409408009007069070285104080006830012074906040002041020698602001003090008501,217856439458239167369174285124987356835612974976345812541723698682591743793468521,0.04700059996685013,39,1420,1381
340009100100030769200060004461000508500000001703000246800050003924070005005400027,346789152158234769279165384461927538582346971793518246817652493924873615635491827,0.16798740002559498,45,7577,7532
300000009100050006079030140002080900580792061607504208700963004904070602060401090,356147829148259376279638145412386957583792461697514238721963584934875612865421793,0.06022899999516085,41,2101,2060
201050809400109007500060003128543976000296000600000005372914658010602030006000100,261357849483129567597468213128543976754296381639871425372914658915682734846735192,0.04422439995687455,40,1294,1254
107352608058060340300070005502080409000090000980704062020030050704020806005000700,147352698258169347369478215512683479476295183983714562621837954794521836835946721,0.40441319998353720,44,19159,19115
207030508150492067300050004002378900400010003890000015021040870704209601000060000,247136598158492367369857124512378946476915283893624715621543879734289651985761432,0.02052119997097179,42,129,87
307050401180006003524090678200000009075912006800000005631040982940001007702060304,367258491189476253524193678213685749475912836896734125631547982948321567752869314,0.03249349998077378,39,677,638
296317458003468200400050003307000905000090000820030047080020090700901006905070302,296317458153468279478259163317684925564792831829135647681523794732941586945876312,0.11496380000608042,42,4783,4741
351040789000179000209080106102090607000050000500000001014502970000817000807060502,351246789468179235279385146182493657793651824546728391614532978925817463837964512,0.09421240002848208,44,3740,3696
107030896200109407060470051410000500500814000890000300020980045600702109905040723,147235896258169437369478251412396578573814962896527314721983645634752189985641723,0.02386670000851154,39,287,248
146050308350009000070010006402000059000921000690000201800030070000100083905070412,146257398358649127279318546412763859583921764697584231861432975724195683935876412,0.45572100003482774,46,21950,21904
348060257100508006670040098000406000000392000500000004701604905950781043804030702,348169257129578436675243198213456879487392561596817324731624985952781643864935712,0.03233370004454628,40,727,687
147060239000349000009070500000090000000218000906507401601953804700080002805020103,147865239258349716369172548512496387473218695986537421621953874734681952895724163,0.04192210000474006,43,1198,1155
300240695060108007074000082120000903485690000790000508031000079040901006900830214,318247695269158437574369182126785943485693721793412568631524879842971356957836214,0.02826380002079532,40,516,476
135060289060009007000000100304500010600832004050001803003000000900700030547020691,135467289268159347479283156384576912691832574752941863813694725926715438547328691,0.33516809996217489,46,15742,15696
457060238000354000360080054020000090500813007700906003600090005940000061875030942,457169238218354679369287154123745896596813427784926513631492785942578361875631942,0.08952689997386187,41,3601,3560
453010782000040009279000106300500408680491000700800501521000604000020005847060923,453619782168247359279358146312576498685491237794832561521983674936724815847165923,0.02583070000400767,40,379,339
107060803300415009000000000015040390704050206890000054900873002680591037070020080,157269843328415679469387125215746398734958216896132754941873562682591437573624981,0.02657929999986663,42,453,411
100205090208169037000000001412300070503810062896500010000000005604752089900601020,147235896258169437369478251412396578573814962896527314721983645634752189985641723,0.04294910002499819,41,1253,1212
351040697470000850000100000100402085000080000590706002000007000024000078765030129,351248697472369851689175243136492785247583916598716432813927564924651378765834129,0.11171430000104010,46,4578,4532
457268139900040008000000000201050807070090020600427001504080703020000080896030512,457268139932145678168379245241653897375891426689427351514982763723516984896734512,0.03307039994979277,42,694,652
410060529200000080600290007102000095090080040740000103500036004070000008834020051,417368529259147386683295417162473895395681742748952163521836974976514238834729651,0.19051400001626462,46,8663,8617
007201089158000000269070050012003070600000003080900510020030498000000761870109300,347251689158496237269378154412583976695712843783964512521637498934825761876149325,0.04055249999510124,45,1085,1040
468030019020007068570068004200006903630980000800004605940023006050001092382050071,468235719123497568579168234214576983635982147897314625941723856756841392382659471,0.02949260000605136,39,558,519
100095078408020000279038104001000000340000065000000300507860493000010506860350002,136495278458127639279638154681543927342971865795286341517862493923714586864359712,0.03295070002786815,45,738,693
158267349060000070470389015000090000500000003096000450021070530930000086800635002,158267349369451278472389615213594867584716923796823451621978534935142786847635192,0.11301470000762492,42,4761,4719
200019068100000000089470025005067082010000070790240600520093840000000009970850001,257319468164582397389476125435167982612938574798245613521793846843621759976854231,0.17016740003600717,45,7446,7401
418237569060549070570060043000070000830000016796000432280753094000000000900604001,418237569362549178579168243124376985835492716796815432281753694643921857957684321,0.09136670001316816,40,3579,3539
100036089258009000309005012004002008600000001900700200420800907000900846890540003,147236589258179634369485712514692378672358491983714265421863957735921846896547123,0.08119260001694784,45,3123,3078
136458279000030000498060351000302000900000007375000426700684003540000062800925004,136458279257139648498267351614372985982546137375891426721684593549713862863925714,0.04753789998358116,40,1471,1431
210060089050179060460020037020897040600000008890000021001683900030000070900752003,217364589358179264469528137123897645674215398895436721741683952532941876986752413,0.05553249997319654,43,1906,1863
047263580000104000360578014000010000580000027690050048014635890900000006800729001,147263589258194673369578214473812965581946327692357148714635892925481736836729451,0.08505740005057305,41,3173,3132
235010789067398240009020100070040060500000007026000490612070953900000002700932004,235416789167398245489527136371249568594681327826753491612874953943165872758932614,0.05384119995869696,41,1763,1722
007468059050000060200751040000080002580104036600070000010925004020000070940817500,137468259458239167269751348371586492582194736694372815713925684825643971946817523,0.20948149997275323,45,9444,9399
000030000009148200270906041020000070690000084780010032517364829800000006960825013,146237598359148267278956341421683975693572184785419632517364829832791456964825713,0.05446080002002418,40,1829,1789
040237098300040000008900341021680075690002104085410032007300829800090000060825013,146237598359148267278956341421683975693572184785419632517364829832791456964825713,0.02044069999828935,38,94,56
005000769167050000380407215000000058650091430000000026510902684926080000004000592,245138769167259843389467215431726958652891437798345126513972684926584371874613592,0.13360000000102445,41,5836,5795
040010078000270503200008041052030009000492000900080720520900007704021000830040010,345619278168274593279358641452137869687492135913586724521963487794821356836745912,0.17205369996372610,46,7698,7652
230000015108020309569103248000000000000531000690040032703050904020010060056080720,237498615148625379569173248381962457472531896695847132713256984824719563956384721,0.21708750003017485,43,9989,9946
350401079109030508274508163000050000000972000700000002901040605600010004045020730,358461279169237548274598163412356897583972416796184352921743685637815924845629731,0.06071310001425445,43,2047,2004
245000060107250003380407205000020058000891407000040026510902604906580001874000090,245138769167259843389467215431726958652891437798345126513972684926584371874613592,0.03212819999316707,40,690,650
030000080250080064490607025000060000000328000680090032501473806800050007069010540,136245789257189364498637125312564978974328651685791432521473896843956217769812543,0.03274679998867214,44,732,688
410000089320060074569708132105090408000304000790000065800070006002981700073020850,417235689328169574569748132135697428286354917794812365841573296652981743973426851,0.02031070005614311,40,125,85
136200070400170206070306104500080017000792005600010023010905608900860702865400090,136248579458179236279356184524683917381792465697514823712935648943861752865427391,0.03902710002148524,39,1041,1002
105026009097000016400009235600040000720803561800010000300002958072000043906034002,135426789297358416468179235613245897724893561859617324341762958572981643986534172,0.16292759997304529,42,7485,7443
300607902086000307090350460400030090860501034900080010010870620028000103600104805,345617982186249357297358461451736298862591734973482516514873629728965143639124875,0.01956919999793172,41,70,29
210340905300000204070008010060072009500806001800410050020700090703000008905031027,216347985358169274479258316164572839532896741897413652621784593743925168985631427,0.20987720001721755,45,9564,9519
258140007160000204000009050006000029480503076590000400020700000604000013900061742,258146397169357284743289651316478529482593176597612438821734965674925813935861742,0.18494819995248690,45,8362,8317
205080706007302800080070020000268000870409051090010080013000960908040507700953008,235184796167392845489576123351268479872439651694715382513827964928641537746953218,0.03778910002438352,43,1021,978
347156928208000106000070000000743000480912037090000010001000700900827001805461203,347156928258394176169278345512743869486912537793685412621539784934827651875461293,0.04734490002738312,41,1366,1325
251030089000100470000008003012000090034289510060000230100600000078004000940050762,251437689386192475497568123512346897734289516869715234125673948678924351943851762,0.03316930000437424,46,738,692
108207604302459108000168000000040000500020007090603010601000809925010763007596200,158237694362459178479168325213745986586921437794683512641372859925814763837596241,0.05001459998311475,41,1687,1646
306040709000108000000070000100090008034856970008010200001904800940507012057621390,316245789479168523582379146165792438234856971798413265621934857943587612857621394,0.02982130000600591,43,593,550
201030609000000000007568100512306897034289510800010004100000008000020000943851762,251437689386192475497568123512346897734289516869715234125673948678924351943851762,0.03811349999159575,41,923,882
126050478300200590090000000260070809005104367470090205010000000700900620839010754,126359478347281596598467132261573849985124367473896215612745983754938621839612754,0.08187449997058138,41,3051,3010
354060798060080030702395104240109056010853020508020301000000000005000600800942003,354261798169487235782395164243179856617853429598624371421536987935718642876942513,0.39782429998740554,41,19195,19154
145070963000090000279050814402000109000931000900080006500000007000615000830729051,145278963368194725279356814482567139657931248913482576521843697794615382836729451,0.38293960003647953,44,18047,18003
237050460100009050069400108300000780000702000085000002401003890050800004076040231,237158469148269357569437128312594786694782513785316942421673895953821674876945231,0.02681420004228130,45,400,355
251030689000090000007060100502040807030289010800010004005673900000000000943851762,251437689386192475497568123512346897734289516869715234125673948678924351943851762,0.07426979998126626,43,2649,2606
258040796100270000000068102302000004080917253507000001000094305700130000936050417,258341796163279548479568132312685974684917253597423681821794365745136829936852417,0.05513390002306551,40,1822,1782
340010028000472000079000610481000369050030080700080005500297006800503001930861052,345619728168472593279358614481725369652934187793186245514297836826543971937861452,0.02740729996003211,41,472,431
350090401100850030479016005003060007004073612007020004721089003800740020940030108,358297461162854739479316285213465897584973612697128354721689543835741926946532178,0.03631409996887669,39,970,931
031465000450100002009000004000306950340070086067502000500000800700003025000759430,231465798458197362679238514182346957345971286967582143513624879794813625826759431,0.13038139999844134,46,5509,5463
057146089100035067062000500001903075500600094008407021014000900900014036036579042,357146289189235467462798513241983675573621894698457321714362958925814736836579142,0.03201480000279844,37,682,645
047196058100203009000000037402307006780900510605804002000000043800701005076435021,347196258158273469269548137412357986783962514695814372521689743834721695976435821,0.02911420003511012,40,520,480
000427000400109005089365740000601000100030002068294150902040607000070000857010324,531427896476189235289365741324651978195738462768294153912543687643872519857916324,0.09419050003634766,42,3748,3706
000317000100209005079568120400605007007192400003704200701000809050020040934806512,245317698168249375379568124412635987587192436693784251721453869856921743934876512,0.04249909997452050,39,1239,1200
047006208100070000009540137402307986700060500605804372001680743800020000076005801,347196258158273469269548137412357986783962514695814372521689743834721695976435821,0.02491370000643656,38,352,314
257060389108203607009070100000000000680000074795000813070902060800705001934816725,257461389148293657369578142412387596683159274795624813571932468826745931934816725,0.03544269996928051,38,882,844
047138506000200007060000021010700603030010050806005070520000060600004000904621730,247138596158269347369457821415792683732816954896345172521973468673584219984621735,0.42662699997890741,46,20121,20075
046587310000109000100040006400000008063090140985406732020634050600000004594020863,246587319358169427179243586412375698763892145985416732827634951631958274594721863,0.19239849998848513,40,8828,8788
126478359058000240000020000500000003703952406804000501007000100280701064601040805,126478359358196247479523618562814793713952486894367521947685132285731964631249875,0.13645569997606799,41,5844,5803
056080490208419706409050108000000000090030060680904015010602040700000003965803271,156387492238419756479256138341568927592731864687924315813672549724195683965843271,0.06307220004964620,41,2271,2230
027418590058679240000030000200000007080761030790000054001245800900000005805396401,327418596158679243469532718213954687584761932796823154631245879942187365875396421,0.04115279996767640,41,1144,1103
056034807000109203200078100080400005510390680090800001700085400000603708063041509,156234897478169253239578164382416975514397682697852341721985436945623718863741529,0.02452390000689775,41,307,266
146375802050109603300060000003590007610820040007410006900050000060904701784631905,146375892258149673379268514423596187615827349897413256931752468562984731784631925,0.02364359999774024,38,277,239
140235608000008507500070000210500906490061083670900405800040000000002701750319804,147235698362198547589476132213584976495761283678923415821647359934852761756319824,0.01925010001286864,41,44,3
100679284060100009070400000324000007005030400700000853000004070900001040842795006,153679284468152739279483165324518697685937421791246853516324978937861542842795316,0.36986789997899905,46,17302,17256
208345709059608230470010086302000908580090023000803000020000050905701602640030091,268345719159678234473219586312456978586197423794823165821964357935781642647532891,0.03810780000640079,39,1052,1013
107245609000369000400000005504826703090457010700903002001000900943000521070192060,137245689258369147469781235514826793392457816786913452621534978943678521875192364,0.07282410003244877,40,2804,2764
107264509000319000400000003001020700682070354700803001010000070520030016870192035,137264589258319647469587123341625798682971354795843261913456872524738916876192435,0.09670290001668036,41,4012,3971
107305209050196040060070080501234906490010053600000001000000000925040638800529004,147385269258196347369472185581234976492617853673958421714863592925741638836529714,0.03305110003566369,41,766,725
107238000058069001200000080601002508082596037503001604800000050025084006906715000,147238965358469271269157483671342598482596137593871624814623759725984316936715842,0.05592849996173754,40,1895,1855
136008050050069038400000020300050206892306015700080903500000070020013094974005060,136278459257469138489531627341957286892346715765182943513694872628713594974825361,0.06116780004231259,42,2084,2042
205139000060084009300500420400000706573016084900000103600700840020041005804623000,245139678167284539398567421412358796573916284986472153631795842729841365854623917,0.02846830000635237,42,496,454
200570903100230060300008502401002009090000030700100805604900008020017006807045001,246571983158239467379468512481352679592786134763194825614923758925817346837645291,0.04852509999182075,45,1509,1464
005206800020389010680050043201000705850000091900000008100734002502060907063925180,315246879427389516689157243231498765854672391976513428198734652542861937763925184,0.03052939998451620,40,631,591
408657100100030060000040705501004008380000047600700503803020000020070001006813902,438657129157239864269148735571364298382591647694782513813925476925476381746813952,0.09725280001293868,45,3973,3928
002358700030907010679020358305000901180000062200000003720583049000040000804792105,412358796538967214679124358345276981187439562296815473721583649953641827864792135,0.02265619998797774,40,196,156
008104300170098000439007080210000768380700592590000134821005040740086000005403800,658124379172398456439657281214539768386741592597862134821975643743286915965413827,0.02539690001867712,39,331,292
104008609360459200000007005500072004002000500900840002400900000005714083703500401,154238679367459218289167345531672894842391567976845132418923756625714983793586421,0.08610680000856519,45,3382,3337
270348609100569000000002058510400307480200061790800502000004095900785000650921804,275348619148569273369172458512496387483257961796813542821634795934785126657921834,0.02225009998073801,38,199,161
003589407500104300408007052120000906370200001980000205601002094700905600009641703,213589467567124389498367152124758936375296841986413275631872594742935618859641723,0.04743679997045547,39,1405,1366
000385409470096200300007016100600805750903024900500107500002048690031700000459301,261385479475196283389247516132674895758913624946528137513762948694831752827459361,0.02489800000330433,39,355,316
130450600200607013000002507300260805000000000504081002803900000920806004006013098,137458629258697413469132587371269845682345971594781362813924756925876134746513298,0.69088000000920147,45,34174,34129
200050008500109003070284050103745809000901000607823504702090305900010002050402070,241356798568179423379284156123745869485961237697823514712698345934517682856432971,0.09532000002218410,41,3764,3723
006020100100604003200109007410258076000000000705496201501040608900000004074965310,346527189197684523258139467413258976629371845785496231531742698962813754874965312,0.13251419999869540,42,5663,5621
230500400108307006509000018300068005000702000600150003820000604700205109004006032,236581497148397526579624318312468975495732861687159243821973654763245189954816732,0.02743660000851378,45,455,410
217450600308002047000000102100037809000000000705940001501000000840600705006025413,217459638358162947469378152124537869693281574785946321531794286842613795976825413,0.94275760004529729,45,45948,45903
150730000200109086309004500400380005060000020900012003001800709790605001000071042,156738294247159386389264517412386975563497128978512463621843759794625831835971642,0.18494229996576905,45,8400,8355
106080207400601008089000360310508096000106000507294803600040009700912004040763020,156389247473621958289457361312578496894136572567294813621845739735912684948763125,0.01906999998027459,40,43,3
208030605300209008070504020403695701000302000507841302700458006800010007060020010,248137695351269478679584123423695781186372549597841362712458936834916257965723814,0.08601269999053329,41,3392,3351
046030809208106004509400006400761908300904060600853201703500002904607003065010407,146235879278196354539478126452761938381924765697853241713549682924687513865312497,0.02446030004648492,37,308,271
045060802108209007209008506500682903700005060800713205407001609901806004082070301,345167892168259437279348516514682973723495168896713245437521689951836724682974351,0.02163959998870268,36,145,109
079100008500408009604309500100782405200604080400513706701906800900807001065200007,379125648512468379684379512136782495257694183498513726721936854943857261865241937,0.02112220000708476,39,144,105
048030005301009078609080003403605701180302040507801302702050006804006057065020004,248137695351269478679584123423695781186372549597841362712458936834916257965723814,0.02062440000008792,38,125,87
108000309260308057003409100312000798000702000700183005800030006600875001057621830,148257369269318457573469182312546798485792613796183245821934576634875921957621834,0.03116630000295117,39,654,615
417058003208400051309007204100000079500302410800000032601005807902600045745023006,417258963268439751359167284123584679576392418894716532631945827982671345745823196,0.01903379999566823,38,58,20
217305094300400026000008005502004001103920457604001003000003009700100042946702018,217365894358497126469218735572834961183926457694571283821643579735189642946752318,0.03734580002492294,40,939,899
054000380268040517070050020510000098607902103800615004000803000900020001030591040,154267389268349517379158426512734698647982153893615274421873965985426731736591842,0.02414190000854433,42,283,241
040008395300040006000030180500000068403617509690000003024060000700080002965700030,146278395358149276279536184512493768483617529697852413824361957731985642965724831,0.36131700000260025,46,17357,17311
256408193100000008308060207400305006507286904003947500001000300700000005980632041,256478193179523468348169257492315876517286934863947512621754389734891625985632741,0.03420509997522458,39,758,719
146008095300200006009005307630020009704953802590080004001006908800700001975004023,146378295357249186289165347638427519714953862592681734421536978863792451975814623,0.02723250002600253,40,435,395
148050792209107308070090040400000007305672904096504280001000400900000001650721039,148356792269147358573298146412839567385672914796514283821963475937485621654721839,0.03654920001281425,39,944,905
240019058100060002300208000480002903502196087690004105900605000700080006860043019,246319758158467392379258641481572963532196487697834125913625874724981536865743219,0.05675220000557601,40,2042,2002
030056008100000706068000104300000040724593681090000005601000870502000009900760010,437156298159248736268379154315682947724593681896417325641925873572831469983764512,0.15935140004148707,46,7003,6957
135270080200000057090008000802007590500601004064800703000700040640000002050012368,135274689286139457497568231812347596573691824964825713321786945648953172759412368,0.08646570000564680,45,3433,3388
137245689408109702060000050700000008680000071095708240003020800820000013076831420,137245689458169732269387154741652398682493571395718246513924867824576913976831425,0.08123010001145303,38,3147,3109
310857024400109006000206000160000089200601007795408613007000800000503000852764391,316857924428139576579246138164375289283691457795428613637912845941583762852764391,0.01997940003639087,39,54,15
130060059700000001000109000315080796420396085086705320500020007072000840803070502,138267459769548231254139678315482796427396185986715324541823967672951843893674512,0.07392980001168326,40,2789,2749
100030008300000005000608000501020709780905046093407510005070400426000857837564921,154239678368741295279658134541326789782915346693487512915872463426193857837564921,0.02276580000761896,39,246,207
290040018100208009000000000709000306500407001080903020601020805850090073974835162,295346718147258639368179254719582346523467981486913527631724895852691473974835162,0.08365450002020225,41,3211,3170
240050017100609003009104500410060098080503070003801600801030704064702130507010809,246358917158679243379124586415267398682593471793841652821935764964782135537416829,0.02088619995629415,39,112,73
340070291108904005209130087012000809080060000097000302701690048804705006960040173,346578291178924635259136487412357869583269714697481352721693548834715926965842173,0.02306009997846559,37,235,198
340060109051409608600107230010000907470690000080000403700903840034806705860040301,347268159251439678698157234512384967473691582986572413725913846134826795869745321,0.02087770000798628,39,111,72
037150860100206340400300050300580006580719003700460008600800090900601280045920630,237154869158296347469378152314582976586719423792463518621835794973641285845927631,0.04200880002463236,39,1210,1171
150040709027109400408500012002050804980620000004070603201400068035802100840010205,156243789327189456498567312762351894983624571514978623271435968635892147849716235,0.02735539997229353,39,460,421
360050190102093000500000000200309078400782005790405002000000009000970506054030021,367258194142693857589147263215369478436782915798415632671524389823971546954836721,0.21519329998409376,46,9716,9670
250030068604000109183000725300824006000070000000316000031090680040000050867040291,259137468674258139183469725315824976426975813798316542531792684942681357867543291,0.02045780001208186,43,107,64
254060738100307005000200000500402309640893001700605204000700000400901007937080412,254169738168347925379258146581472369642893571793615284815724693426931857937586412,0.03138770000077784,41,637,596
016340509407000000398060010180470006520091807760280004631050040802000000075830201,216348579457129683398567412183475926524691837769283154631952748842716395975834261,0.02426809997996315,39,319,280
147050269208106307300070008500000002490785036706000904020000090004507600870030021,147358269258196347369472518531964872492785136786213954623841795914527683875639421,0.09534459997667000,41,3962,3921
047050629008300701100000000510700006480090073900006058000000007705001300834070910,347158629258369741169247835512783496486592173973416258621934587795821364834675912,0.15778800001135096,46,6905,6859
045679230206008900000050007600703004750096102800205006000030009508004700031867420,145679238276348951389152647612783594753496182894215376427531869568924713931867425,0.04018919996451586,41,1136,1095
641278359307149208000050000100000006400090005906502403010000070003904500094020630,641278359357149268289356147125437896438691725976582413512863974763914582894725631,0.08600170002318919,42,3352,3310
254169738100040005300050006000402000042090570700615004810000093000000000937586412,254169738168347925379258146581472369642893571793615284815724693426931857937586412,0.06998159998329356,41,2431,2390
257168349408090702100070008070206090502030406600050003010000050900000007046985230,257168349468593712139472568371246895592831476684759123813627954925314687746985231,0.08835490001365542,41,3452,3411
305678201068000350200153004410000078600487005800912006020000080004806500086020740,345678291168249357279153864412365978693487125857912436521734689734896512986521743,0.03044449997832999,40,633,593
045670091000200007209003000010305008603080105800902030000700609700006000980021740,345678291168249357279153864412365978693487125857912436521734689734896512986521743,0.12312589999055490,46,5116,5070
206174009308005006400300001160500048583000120790800035800900004907006002601752003,256174389318295476479368251162537948583649127794821635825913764937486512641752893,0.02142930001718923,40,137,97
127356489500029300000400002200607095086090700700203064000800007900014600874965231,127356489548129376369478512213647895486591723795283164651832947932714658874965231,0.02066070004366338,37,90,53
315468927200009405070005000100000050053046209600000070020003000900004501847651392,315468927268179435479235168182397654753846219694512873521983746936724581847651392,0.12021660001482815,41,4988,4947
203468709100529008090000060340000076002090800980000032000030000027040680839756421,253468719176529348498317265341285976762193854985674132614832597527941683839756421,0.09573330002604052,41,3807,3766
200560380508000107300080065182000000453291076697000000700040098905000604800950730,214567389568329147379184265182476953453291876697835412721643598935718624846952731,0.05347250000340864,41,1792,1751
107368204400000003009000100312070859870090012090000060020030040003080600785246931,157368294468129573239457186312674859876593412594812367621935748943781625785246931,0.07772450003540143,41,2841,2800
204567309008000100079000260182000953050090070090805010000040000005708600846952731,214567389568329147379184265182476953453291876697835412721643598935718624846952731,0.08026979997521266,41,3162,3121
260073450500000003304500072005300007400090006800007300740002508900000004083950021,268173459579428163314569872125346987437895216896217345741632598952781634683954721,0.10562019998906180,46,4305,4259
107368209008000300203000106301070608740892031000000000002981400600040007014736950,157368249468129375293457186321574698746892531985613724572981463639245817814736952,0.02880559995537624,41,545,504
340915026108000309060000040401060207502080901000107000000050000700891003985634712,347915826158246379269378145431569287572483961896127534613752498724891653985634712,0.02418030000990257,41,238,197
000457000050000070679103425100000008800592004007814300020635040080020030365040291,213457689458269173679183425142376958836592714597814362921635847784921536365748291,0.04999540001153946,41,1568,1527
136040598008000700470508061300080007680000052090402080902371805000020000817050623,136247598258169734479538261324685917681793452795412386962371845543826179817954623,0.04489119997015223,40,998,958
200047580500000203340008701120500800407012056690700400810005904900000605700029130,261347589578196243349258761123564897487912356695783412812635974934871625756429138,0.02145130001008511,41,166,125
100250370008070006007100504001400007402090108900006400609005700700040800054037001,146258379598374216237169584361482957472593168985716432619825743723641895854937621,0.11458709998987615,46,4732,4686
207010309108000207340267015400020008580090073000805000000936000905080406030542090,257418369168359247349267815471623958582194673693875124714936582925781436836542791,0.09240909997606650,42,3776,3734
458030190000000508200180036340900705502301049980400301600570083000000604835090210,458736192163249578297185436341928765572361849986457321614572983729813654835694217,0.02568449999671429,39,364,325
250418060100050207300007805470600900502094073690800100700006502900080406830542090,257418369168359247349267815471623958582194673693875124714936582925781436836542791,0.03128150000702590,39,623,584
100239080350000702000500001400908507500070004701605008600002000804000056070416003,147239685358164792269587341436928517582371964791645238613852479824793156975416823,0.24964659998659045,46,11484,11438
240690130100000009070050062400300005583000726700005001620030080900000004054069013,245697138168423579379158462412376895583941726796285341621534987937812654854769213,0.05666090000886470,45,1942,1897
560090038407030205300000006130502089000080000896010523010000050700925001058671340,561297438487136295329458176134562789275389614896714523612843957743925861958671342,0.09451580001041293,41,3715,3674
205038070010400008090070102100003000573010246000200007601050080800007050050380604,265138479317492568498576132142763895573819246986245317621954783834627951759381624,0.06347019999520853,46,2293,2247
140378092278090631000010000400907005580060074690584023020000050000000000960721048,146378592278495631359216487412937865583162974697584123821643759734859216965721348,0.05542729998705909,41,1828,1787
140836090000009600060200400500007940480060017096400002001003050004500000030724068,147836295258149673369275481512387946483962517796451832821693754674518329935724168,0.05299200001172721,46,1683,1637
300251008158497263209030504500306009407000605960000082020000050700915006000762000,346251798158497263279638514512386479487129635963574182621843957734915826895762341,0.01955559995258227,40,89,49
054217096208359074070000000600700385500000769700800412010000000806973041037541028,354217896268359174179486253641792385582134769793865412415628937826973541937541628,0.02818699995987117,37,454,417
230479018108000709009080400300208005405090301600315007020804050800906004004751200,236479518148562739579183462317248695485697321692315847721834956853926174964751283,0.02036229998338968,40,133,93
140367098286040753007080100402601809060090070000000000010702080600804007708916405,145367298286149753397285164452671839861493572973528641514732986629854317738916425,0.03568629996152595,40,841,801
320040079158209643409050208201603907560090084890000026010000090000905000005461700,326148579158279643479356218241683957563792184897514326612837495734925861985461732,0.02149160002591088,39,167,128
106249008200601093000507000003700009804093265002400007000302000300904051905816002,136249578257681493489537126613725849874193265592468317761352984328974651945816732,0.13690029998542741,42,5977,5935
246537089100409060070000005000305098683090051000608032020000004800901020964752013,246537189158429367379186245412375698683294751795618432521863974837941526964752813,0.02281289995880798,39,224,185
154307089360000010200008653000439000600080395000526000800002534420000070937804062,154367289368295417279148653581439726642781395793526841816972534425613978937854162,0.03751319996081293,40,981,941
137408259050000030060537040040070090700050001590804023600040002000301000875692314,137468259458129637269537148341276895782953461596814723613745982924381576875692314,0.11660710000433028,40,4978,4938
207305619000200403300070250001600090400000006090001700014020007705009000936708504,247385619158296473369174258581647392473952186692831745814523967725469831936718524,0.04876989999320358,45,1504,1459
147306258050000070200080004071030890500010003000875000004050600720000089836749521,147396258358421976269587314471632895582914763693875142914258637725163489836749521,0.02942720003193244,41,533,492
016208390300100006200076040002000059403000207590000400020690004600007002075401680,716248395348159726259376148162734859483915267597862431821693574634587912975421683,0.06963969999924302,45,2560,2515
245109687160000439009000100010004070700081354050003060001000700530000248978302516,245139687167258439389476125613594872792681354854723961421865793536917248978342516,0.09480989997973666,39,3791,3752
147305600250060007009087020000000008406010503500000000070250300800090056005706812,147325689258961437369487125712534968496812573583679241671258394824193756935746812,0.23279819998424500,46,10845,10799
300105009410279056570060024000000000280090041607804205005406900900080002062951470,326145789418279356579368124154632897283597641697814235735426918941783562862951473,0.03423770004883409,40,816,776
716208095340050006000006000062034009400000007500860430000600000600080012970401683,716248395348159726259376148162734859483915267597862431821693574634587912975421683,0.27140250004595146,45,12555,12510
460308079170000006000067020006500098308000205740002600020780000900000017850901062,462318579173259486589467123216534798398176245745892631621783954934625817857941362,0.17925360001390800,45,8178,8133
496007813120040069500160000000680000305090187000570000600930000740010026859006431,496257813127348569538169274274681395365492187981573642612934758743815926859726431,0.04120869998587295,41,1145,1104
147305689250060007360480005010000900006002573080000200670250004820090006935706812,147325689258961437369487125712534968496812573583679241671258394824193756935746812,0.01977349998196587,38,89,51
206107408370040056010080030083902560504361702000804000801000609000608000760493021,256137498378249156419586237183972564594361782627854913831725649942618375765493821,0.02037410001503304,39,105,66
316708942207030506590060017000000000403605108080412060800000005000571000054823690,316758942247139586598264317162387459473695128985412763831946275629571834754823691,0.02745459997095168,40,472,432
320509078108070905570080021200305007403761802000408000702030504000000000065942710,326519478148273965579684321281395647493761852657428139712836594934157286865942713,0.05724210001062602,40,1996,1956
140203089000000704360008102400302060582097403600504020810005306000000201720901048,147253689258169734369478152471382965582697413693514827814725396935846271726931548,0.05178249999880791,40,1690,1650
346207001208000036100008500000405300400010007007603000001500008930000105800701423,346257891258149736179368542612475389483912657597683214721534968934826175865791423,0.08449099998688325,46,3233,3187
140205098008000301360080204400300900780052103500800700620090407004000509930701062,147235698258469371369187254412376985786952143593814726621598437874623519935741862,0.03956840001046658,41,1062,1021
107309508208010907360000024403257806500090002090604010600783009700000001980102073,147329568258416937369578124413257896576891342892634715621783459734965281985142673,0.02531679999083281,39,343,304
207300086100040039300000005001403900400186007003502400700000003820030004930004501,247359186158647239369218745581473962492186357673592418714965823825731694936824571,0.52170489996206015,46,25142,25096
103548679060100000509000004200400700380751206600800500806000007040300000701684923,123548679468179352579263184215496738384751296697832541836925417942317865751684923,0.10431709996191785,42,4234,4192
043509200700080090280000006000658900010293040006471000400000069070010004008704510,143569287765182493289347156324658971817293645956471328431825769572916834698734512,0.07199580001179129,46,2726,2680
500200948080140007304000002107408200250391406409705300703000004020610003900800125,571236948682149537394587612137468259258391476469725381713952864825614793946873125,0.02676370000699535,40,431,391
037500942400000030209030001000005190700392005096700000600040509070000004845006210,137568942458129736269437851324685197781392465596714328612843579973251684845976213,0.14804719999665394,46,6372,6326
230410908100009000400700002301007000870142069000500207500004003000900005906025041,237416958158239476469758132321697584875142369694583217512874693743961825986325741,0.15041579998796806,46,6462,6416
058267340060050020270498061000503000080679010507000206800000003900000004746135892,158267349469351728273498561614523987382679415597814236825946173931782654746135892,0.03676479996647686,40,908,868
047536280000070000360080057000000000403957602706208503001000900900020001835791426,147536289258179364369482157512364798483957612796218543621843975974625831835791426,0.25567759998375550,41,11813,11772
000100389350090100079008504000780006402615703000230001013002605720060900000900412,246157389358496127179328564531789246482615793697234851913842675724561938865973412,0.04863159998785704,42,1531,1489
047238560000000000069050120000326000030090040602000803010080070904613205026745390,147238569258169734369457128481326957735891642692574813513982476974613285826745391,0.06769260001601651,42,2365,2323
230184069000609000060375020014090680680050093005000400000060000703010806096040270,237184569158629347469375128314297685682451793975836412521768934743912856896543271,0.22683380002854392,44,10435,10391
230010098000000000068000250006587400402060307709302605000934000600020001094671530,235416798947258163168793254316587429452169387789342615521934876673825941894671532,0.02883060002932325,43,512,469
140030069000000000069457120080020050730090042600000003010982070970613085026040390,147238569258169734369457128481326957735891642692574813513982476974613285826745391,0.11674619995756075,42,4743,4701
140020068000109000069070520012586390870010045500000002000030000904050806085694210,147325968258169734369478521412586397873912645596743182621837459934251876785694213,0.03856469999300316,42,973,931
150467089006000700090050030004576900000030000900000007020613070608040102041982560,153467289286391745497258631314576928872139456965824317529613874638745192741982563,0.12887099996441975,44,5539,5495
247060518000000000060185070402090603080512040000000000000624000804903701936070425,247369518158247396369185274412798653683512947795436182571624839824953761936871425,0.04964380001183599,43,1515,1472
130406298406100000207358040800000300900061850500000600308714060601900000750602431,135476298486129573297358146862547319973261854514893627328714965641935782759682431,0.02588590001687407,40,371,331
136289574000000000490157062204060903305090406000010000001020800800901007960804051,136289574527346198498157362274568913315792486689413725741625839852931647963874251,0.10300950001692399,41,4196,4155
154000308060300009300405020501700903090000080703008201010902007900007010807000592,154269378268371459379485126581726943692143785743598261416952837925837614837614592,0.29004170000553131,45,13668,13623
130200409000190005259407000012000008500809006800000510000905784900081000705002093,137258469468193275259467831312576948574819326896324517621935784943781652785642193,0.25486520002596080,45,12174,12129
307100605100205079509008000270000006480506792690000003802003000700901058906800107,327194685168235479549678321271389546483516792695427813812753964734961258956842137,0.06414930004393682,42,2288,2246
306200100200104009109300254401000600680402593502000700704600935800901006903700800,346259187258174369179386254431597628687412593592863741714628935825931476963745812,0.02247070003068075,40,198,158
107500200200304609009008105603000904500603721701000306002006507800901402906400800,147569238258314679369728145623187954584693721791245386412836597835971462976452813,0.03537599998526275,41,858,817
105070308340000076609308201231060789000907000507000604012090560800706002904030807,125679348348251976679348251231465789486927135597183624712894563853716492964532817,0.02035110001452267,39,137,98
200459001150302069400106003310547098700000004804000507541803976000010000903705102,236459781158372469479186253312547698765298314894631527541823976627914835983765142,0.09840700001223013,38,3950,3912
040100009810309004509400610100000805300904001708000006051002908900806053600001040,246157389817369524539428617124673895365984271798215436451732968972846153683591742,0.03222520003328100,45,713,668
471293506050100009369000020104309600090600018607502900812000070030700002746825103,471293586258167349369458721124389657593674218687512934812936475935741862746825193,0.02183199999853969,37,183,146
100030008360109027009508400501302709782000135603000802815000976000906000906871204,154237698368149527279568413541382769782694135693715842815423976427956381936871254,0.03005890001077205,37,652,615
000060389300009040498000170100006508020030010907500003012000964040600001869050000,251467389376819245498325176134276598625938417987541623512783964743692851869154732,0.75298820005264133,46,37180,37134
240361095058020360009000100702906408000000000095782610521000784000807000806254901,247361895158429367369578142712936458683145279495782613521693784934817526876254931,0.02669690002221614,39,437,398
400050009286040357009267800100000004060090030895010276310000098600000002902781403,471358629286149357539267841123576984764892135895413276317624598648935712952781463,0.04033599997637793,41,1083,1042
400030009520070046093000720100000004050781090870090052041000960000607000765943218,417236589528179346693458721139562874254781693876394152341825967982617435765943218,0.06300860003102571,42,2211,2169
200040789400000000389000610120007508570000023608500047012000856000000002946050001,251346789467189235389275614123497568574618923698523147712934856835761492946852371,0.04336299997521564,45,1212,1167
200130409100000003300060580002306908080010040507402300021040005800000004906053002,258137469164598723379264581412376958683915247597482316721649835835721694946853172,0.06088919995818287,46,2148,2102
210345098307080406090206050000000000570090061980060042001050800000804000805637209,216345798357189426498276153164523987572498361983761542631952874729814635845637219,0.12132099998416379,43,4990,4947
100329008008060900360501072500402009400010005603807104714000356000000000836145297,147329568258764913369581472571432689482916735693857124714298356925673841836145297,0.02666420000605285,39,392,353
400210396168009002293060080300700009020190068800500001631020050782005004900670823,457218396168359472293467185316782549524193768879546231631824957782935614945671823,0.02337999996962026,38,285,247
350460290200000100070080005520608009100090002600201073700040080005000004046029031,351467298268935147479182365523678419187394652694251873712543986935816724846729531,0.17585420003160834,46,7744,7698
260070483310000009570340002100000900080090030007000005700052094800000057956030021,269175483314628579578349162123567948485291736697483215731852694842916357956734821,0.05966770002851263,46,2070,2024
310240580008009060009708124000001708190087036000002901001604895004003070970820410,317246589428159367569738124642391758195487236783562941231674895854913672976825413,0.03057200001785532,39,606,567
020050090406139205590268034000000000160090027049080360670010059000000000854020713,321457896486139275597268134235671948168394527749582361672813459913745682854926713,0.25968369998736307,42,11907,11865
030020090200000003460138027302070409780050016090301080021060970000080000976010835,137425698258697143469138527312876459784952316695341782821563974543789261976214835,0.05826970003545284,42,1960,1918
240378019100000008000156000003060900060893050095010640001934800600000004974080235,246378519157249368389156427713465982462893751895712643521934876638527194974681235,0.05080550001002848,42,1667,1625
210349086450000039060852040106070805080090020004010600001724900000605000805030402,217349586458167239369852741126473895783596124594218673631724958942685317875931462,0.02818379999371246,42,514,472
240009351150302809000000002012006905597810030083005704000000008830901507960007123,248679351156342879379158642412736985597814236683295714721563498834921567965487123,0.02527540002483875,39,348,309
138050794260407035500391006307040902080070040090000070700000009903802507856000423,138256794269487135574391286317648952682975341495123678721534869943862517856719423,0.04537869995692745,39,1410,1371
246007891100000003300068024000006310000020000097800000860470009700000005935600748,246357891158249673379168524482596317513724986697831452861475239724983165935612748,0.33804250002140179,46,15826,15780
158040379200307005400598001006179400080060090004805100000000000900684007847000536,158246379269317845473598621326179458581462793794835162612753984935684217847921536,0.12412180000683293,42,5212,5170
137050689200109037500070001070006004406510020050007006600020005700805063985030472,137452689248169537569378241371286954496513728852947316613724895724895163985631472,0.04053629998816177,40,1127,1087
053080120100402003200105006302746905006913200090000030800364007900000002647020318,453687129168492753279135846312746985586913274794258631821364597935871462647529318,0.02695909998146817,40,395,355
451020738270000049000457000100000006800236007060000020600348005730905082985060413,451629738276183549398457261123574896849236157567891324612348975734915682985762413,0.02607679995708168,40,393,353
007300801050209307300000040504062908600000003701580406010000009805907030906004100,247356891158249367369178245534762918682491573791583426413625789825917634976834152,0.09956780000356957,45,4115,4070
000367008300100057200095003691200004500780631783600009400036002800900045000542006,154367298369128457278495163691253784542789631783614529415836972826971345937542816,0.09953730000415817,41,4066,4025
108050007060308512000000308300840005590610284800590006000000809050901643903020001,138259467469378512275164398316842975597613284824597136641735829752981643983426751,0.02241279999725521,42,205,163
340506009000200067209000005000002803780154092905800000400000908570001000800407021,347516289158249367269378145614792853783154692925863714431625978572981436896437521,0.11842709995107725,46,4885,4839
300150802020400067500000000210045006480020075900360021000000008790004050804073009,347156892128439567569287134213745986486921375975368421631592748792814653854673219,0.24070119997486472,46,10999,10953
400030008210576049009000200100387005370090012906020407040000060650903081700861004,467239158218576349539418276124387695375694812986125437841752963652943781793861524,0.02485659997910261,41,362,321
371200009000519087000000100105370806290480705708950402000000600000124058954800001,371248569426519387589637124145372896293486715768951432812795643637124958954863271,0.02462209999794140,41,342,301
504317608060209010109000203806020904230000086407080301040000070700801009903475102,524317698368249517179658243816723954235194786497586321641932875752861439983475162,0.02009790000738576,39,101,62
300248009020519080509000104105372806200406005000000000010000040607104908954803271,371248569426519387589637124145372896293486715768951432812795643637124958954863271,0.03139909997116774,40,625,585
340056092000409067509200000210005000406000305000300021000002708790804000850670019,347156892128439567569287134213745986486921375975368421631592748792814653854673219,0.08326070004841313,45,3214,3169
253400107000508204000000000310006905620090071904700026000000000802901000709003512,253469187196578234478132659317286945625394871984715326531627498842951763769843512,0.14278679998824373,46,5968,5922
154267839000109207000000000400500900683092501700800300000000000000405602846923715,154267839368149257279358164412536978683792541795814326527681493931475682846923715,0.14285980002023280,42,5811,5769
137400082208070006640000000310500000705090803000007024000000095800020407590001268,137456982258179346649238751314582679725694813986317524472863195861925437593741268,0.04713750001974404,46,1382,1336
158346972200070003000108000402000509003090100590401026700050008800704001946000735,158346972264579813379128654412637589683295147597481326721953468835764291946812735,0.02576910000061616,41,327,286
435071982100050006000008003210503009006197008890406001000002005500010007983065214,435671982128359746679248153214583679356197428897426531741932865562814397983765214,0.02750299999024719,40,458,418
035481960100392008400000001000705000604020305050609020501000406700010002068254710,235481967176392548489567231312745689694128375857639124521873496743916852968254713,0.05915589997312054,42,2021,1979
354179268100283005000000000500010009613704852900000003400801006800060004769040381,354179268176283945298456137542318679613794852987625413425831796831967524769542381,0.02146639995044097,40,154,114
037048596100060004000500028300604000086917432700802000000700063600080009075026841,237148596158269374469573128312654987586917432794832615841795263623481759975326841,0.02491859998553991,41,318,277
158267349309415208070000050000000000786090532590602087600703005800000006040826010,158267349369415278472389651213578964786194532594632187621743895837951426945826713,0.03944950003642589,39,974,935
136248597400359008000000000000403000305000401890705032602901803900000006740536019,136248597427359168589167324261483975375692481894715632652971843913824756748536219,0.02848249999806285,40,459,419
236010579100000008000070000000204000542837196790060043600000004800359001025641830,236418579157923468489576312361294785542837196798165243613782954874359621925641837,0.04933469998650253,41,1520,1479
238146759107309608500070001000407000071692380000010000600905004700000003800734002,238146759147359628569278431352487916471692385986513247613925874724861593895734162,0.08390819997293875,42,3253,3211
410285697207000005500007014000006000376091842000002000600004078802000001750618423,413285697267149385598367214124836759376591842985472136631924578842753961759618423,0.18448659998830408,41,8304,8263
531246879402080503000070000000703000200891006390020015703000408000010000065437290,531246879472189563689375124146753982257891346398624715713962458924518637865437291,0.03208779997657984,42,675,633
045369107100008050000150006503000800017586923802000500000730008700001030038642705,245369187176428359389157246593274861417586923862913574621735498754891632938642715,0.04301600001053885,41,1235,1194
205369107006000300380050046003274800017586920000000000020030090000891000900642005,245369187176428359389157246593274861417586923862913574621735498754891632938642715,0.02377200004411861,44,293,249
351692408060100000070300020126000709000000000904000312010008030000001060805763241,351692478268147593479385126126834759537219684984576312612458937743921865895763241,0.09590060001937672,45,3659,3614
105040609000000000470508013094623150010805040806000307520080094043701860600492001,135247689268139475479568213794623158312875946856914327521386794943751862687492531,0.02259179996326566,39,202,163
301080204000000000480257063023060490000391000806000305000030000038715640705826901,351689274267143589489257163123568497574391826896472315612934758938715642745826931,0.09793320001335815,42,3837,3795
237460108100003000060187034601000905000504016405000703010925067700006000956740302,237469158148253679569187234681372945372594816495618723813925467724836591956741382,0.04856819997075945,39,1506,1467
347651002100000000069370004403000975070903240802000136021430009900000000785169003,347651892158294367269378514413826975576913248892547136621435789934782651785169423,0.02988499996718019,40,592,552
245360701100000040098174026003000052000591073001000094012847035700000060859620407,245369781167258349398174526973486152426591873581732694612847935734915268859623417,0.02595000003930181,38,380,342
105040609000139000400060003704623108000805000806000307001386700900701002680492031,135247689268139475479568213794623158312875946856914327521386794943751862687492531,0.04315949999727309,41,1180,1139
104237508000198000300050001601324807052801340800070006410000072520000083900040005,164237598275198634389456721691324857752861349843975216416583972527619483938742165,0.03854049998335540,41,992,951
204050608100060007006328400341080579000703000800000003000602000528931746907040102,234157698185469327796328451341286579652793814879514263413672985528931746967845132,0.03395019995514303,41,777,736
106040809000309000400000003302060508080102030690000021040000080963854712825731946,136245879258379164479618253312467598584192637697583421741926385963854712825731946,0.02604049997171387,39,398,359
234157008000009000700300450001000079050793010870000200013002005000900000900845132,234157698185469327796328451341286579652793814879514263413672985528931746967845132,0.12331530003575608,46,5285,5239
207419508000627000004000200010040070379162845400000001000804000703951602805070403,237419568958627134164583297512348976379162845486795321621834759743951682895276413,0.07066720002330840,41,2651,2610
146238759000060000009070600020080090670594083800000006000903000038706510764050932,146238759257169348389475621423687195671594283895312476512943867938726514764851932,0.11303440004121512,41,4748,4707
307261409000050000200070006129604578073185690500000001800702005000506000905813704,357261489618459237294378156129634578473185692586927341831742965742596813965813724,0.05528710002545267,40,1848,1808
251340607007000008400000130104080000070496050000020803016000002700000900508072316,251348697367159428489267135124583769873496251695721843916834572732615984548972316,0.25084220001008362,46,11549,11503
204078509070520004509004012300000807090287036800000405601005078040760003703092601,234178569176529384589634712312456897495287136867913425621345978948761253753892641,0.02083340001991019,39,150,111
107246509008050300009000200000020000302491605000583000020000090003762400764010823,137246589248159367659378214415627938382491675976583142521834796893762451764915823,0.09225950000109151,44,3619,3575
010050080208000307000070000180040076600080005004601800400905008905010203836724591,317452689248169357569378124182543976693287415754691832421935768975816243836724591,0.04819729999871925,43,1255,1212
010346080008000200509000306100080009086010520005624800600807002900030008874562193,217346985368159274549278316123785649486913527795624831631897452952431768874562193,0.02594050002517179,41,374,333
030010060106000304409050107300080002672000845805624701000000000020060070964735218,237418569156279384489356127341587692672193845895624731713842956528961473964735218,0.04052300000330433,41,1147,1106
200589601100000248360002000502008000400070009000200106000400057834000002905826004,247589631159637248368142795512968473486371529793254186621493857834715962975826314,0.07275250001111999,46,2679,2633
000358000208000107009000400400572008700090004006843700673080529010000070905736801,147358296258469137369217485431572968782691354596843712673184529814925673925736841,0.04124670004239306,43,1163,1120
107300860400000235039200004201000000390080041000000307800005710913000002056001903,127354869468197235539268174271643598395782641684519327842935716913876452756421983,0.13625619997037575,46,6089,6043
246508370150000600389160500000070804013900005000020703471850900920000400638209150,246598371157432689389167542562371894713984265894625713471853926925716438638249157,0.01902450004126877,39,72,33
001275600060000070079030120100080006430000017007010200610543098050020060984701532,341275689268194375579638124125387946436952817897416253612543798753829461984761532,0.03510079998522997,41,801,760
100254007040000030079368140320407068407000302000020000610705083700040009980632051,136254897548179236279368145325417968497586312861923574612795483753841629984632751,0.02654869999969378,40,432,392
107040509500000007349508216270403095401907302080000070602704908004050600030692040,127346589568129437349578216276413895451987362983265174612734958794851623835692741,0.02228130004368722,38,226,188
050030090200000007400507008345601879791000265800000003502403906683050741910070032,157238694268149357439567128345621879791384265826795413572413986683952741914876532,0.02250159997493029,38,221,183
140238070000000803309007004500002048060010090970800001400600902608000000020985016,146238579257149863389567124531792648862314795974856231415673982698421357723985416,0.30595329997595400,46,14455,14409
050137090300402007400000008140050089683000524700000001500208003824000675907645802,258137496369482157471569238142356789683791524795824361516278943824913675937645812,0.02004390000365674,40,108,68
030154080100000007400708001071080590680000074500000002803906405725301968946020713,237154689158269347469738251371482596682593174594617832813976425725341968946825713,0.02196530002402142,38,179,141
146038070050009003309507004000002008802000705900800000400603902600400050020980416,146238579257149863389567124531792648862314795974856231415673982698421357723985416,0.37281569995684549,45,17876,17831
145387060260000500009002001402050807703018640806070103001006004930000700678495010,145387269267149538389562471412653897793218645856974123521736984934821756678495312,0.02627440000651404,39,408,369
147389526008621400000000000000030000005106800980070041820050064700000005596714283,147389526358621479269547318612438957475196832983275641821953764734862195596714283,0.04117670003324747,41,1117,1076
307268159000000030500004060001080006403906502800020700010700004020000000734891605,347268159162579438589134267251387946473916582896425713618752394925643871734891625,0.11355859995819628,45,4742,4697
307246509240309067500070004400090003103000605706010802600407008000000000974865321,317246589248359167569178234485692713123784695796513842631427958852931476974865321,0.03045750001911074,40,564,524
106457298450000000009060050010020879605003401090010536001080040920000000807395162,136457298458239617279168354314526879685973421792814536561782943923641785847395162,0.05860960000427440,40,2006,1966
106237589200000000370480010010090003483700902090020008820910070900000000705842391,146237589258169437379485216512698743483751962697324158824913675931576824765842391,0.02412940002977848,41,344,303
301040608009178300070060020000090000500806002800020007602030705000902000945687231,351249678269178354478563129124795863537816942896324517682431795713952486945687231,0.16155930003151298,44,7219,7175
147035098050000300369070050010350009605802104080710006521080060030000900896043012,147235698258169347369478251412356879675892134983714526521987463734621985896543712,0.03134550002869219,39,683,644
200137008107000304098050270000070000403000806600304005721000659030060080860921037,246137598157289364398456271512678943473592816689314725721843659934765182865921437,0.16798319999361411,42,7797,7755
208369071070040203506170040010090007405000329090080004801630090050020806904851032,248369571179548263536172948312495687485716329697283154821637495753924816964851732,0.01993379998020828,38,112,74
206307089300000472079200160080500004503006728060900005035700840600000957807605031,216347589358169472479258163182573694593416728764982315935721846621834957847695231,0.04700840002624318,39,1456,1417
200367009300000006080040030037050260560010094002608300006000500040805070753426981,214367859375189426689542137137954268568213794492678315826791543941835672753426981,0.07658310001716018,42,2832,2790
350478069200000003000302000123506487700010006004000500802000305036921870947030621,351478269268159743479362158123596487785214936694783512812647395536921874947835621,0.02035859995521605,39,100,61
407008060002060004003407028230600905164090287750800603001904056005010002806003090,417238569582169374693457128238671945164395287759842613321984756945716832876523491,0.02554469997994602,40,360,320
257106839000000000030208050370802091081050320500000004000000000025931460946587213,257146839168395742439278156374862591681459327592713684813624975725931468946587213,0.02565130003495142,40,370,330
147250890360008070000300060230000600416930028790000300000400080670009010854720930,147256893362198475589374162235817649416935728798642351921463587673589214854721936,0.12807269999757409,42,5408,5366
261358490070100060508007000120000609030080245850000701302004000080600010746813950,261358497473129568598467123124735689637981245859246731312594876985672314746813952,0.02025540004251525,40,119,79
006471500000602000000000000002754900097080420680000015700040009843965271960217034,236471598158692347479538162312754986597186423684329715721843659843965271965217834,0.07627640001010150,41,2533,2492
240050018050209060060107050012030790400902005900010003800070009034801570795020831,247356918158249367369187254512438796473962185986715423821573649634891572795624831,0.03485749999526888,40,829,789
100269008000103000670000012421356897007000600000714000500030009013080260894020735,135269478248173956679548312421356897357892641986714523562437189713985264894621735,0.02516269998159260,41,329,288
008063279160000000203059068300000807002791034600000501704036052920000000005042716,458163279169278345273459168341625897582791634697384521714836952926517483835942716,0.02073009999003261,41,115,74
140038596250009300309000002400690800682000059700820600503000008920001700870056231,147238596258169374369547182431695827682713459795824613513472968926381745874956231,0.04434240004047751,40,1330,1290
306240580087005200000000004050030047603104902890070060200000000005800620068023705,316247589487915236529368174152639847673184952894572361231756498745891623968423715,0.09991440002340823,45,4037,3992
130426058208319406000000000300050007502080604006147200000000000043090780985060342,137426958258319476469578123314652897572983614896147235721834569643295781985761342,0.03762660000938922,42,937,895
300241000027089405008500003002050098800000007930020100200005900503910870000472001,365241789127389465498567213712654398854193627936728154271835946543916872689472531,0.41551810002420098,45,20071,20026
060379080178456239000000000380060057500000006090815020600000008023687540804030702,265379184178456239439128675381264957542793816796815423617542398923687541854931762,0.03103130002273247,41,646,605
060247080209308405400000002390070024501000703027934510900000008034020950708090201,165247389279318465483569172396175824541682793827934516912753648634821957758496231,0.02216059999773279,40,207,167
140238096208169304000000000431090827600000009005824600500000008026080740804050201,147238596258169374369547182431695827682713459795824613513472968926381745874956231,0.05527640000218526,41,1819,1778
010256030208147609000000000170060098300090006000718000700000005043925760956070423,419256837238147659567389214172463598384592176695718342721634985843925761956871423,0.02411499997833744,42,307,265
350281069002509300400000002214738956600000008078020140500000004040010020896050731,357281469162549387489367512214738956635194278978625143521873694743916825896452731,0.03190920001361519,40,654,614
140256093050070020000000000570000034403000902092030170800000005020618040936547281,147256893358179426269384517571892634483761952692435178814923765725618349936547281,0.04990310000721365,42,1566,1524
581000379032090840000000000100060004200804003047512690403000907020781030806439201,581246379632197845794358162158963724269874513347512698413625987925781436876439251,0.02595099998870865,40,391,351
365040289018050470400000005120406057500791003007523100001070800000000000746802591,365147289218359476479268315123486957584791623697523148951674832832915764746832591,0.01949509995756671,40,74,34
218050497069172380500000002180503029020090050095060830000020000900000003850934016,218356497469172385573489162186543729324897651795261834631725948942618573857934216,0.08490150002762675,41,3345,3304
040137080068040370300000002610000053450000096003615700000703000830020067796854231,245137689168249375379586412617492853452378196983615724521763948834921567796854231,0.08098270004848018,40,3129,3089
040209030358040279200000004010080090406513807073060410004000500030020060981605742,147259638358146279269378154512487396496513827873962415624791583735824961981635742,0.02020949998404831,40,103,63
205010306090020080300000004002306800503000602069040150700000008030971020954238761,245817396196423587387695214412356879573189642869742153721564938638971425954238761,0.02007279999088496,42,74,32
108076093060000020000300006090064570601507902087920040800002000020000060730840209,158276493369418725472359186293164578641587932587923641814692357925731864736845219,0.02622950001386926,45,377,332
347009082000270500000008007602000078403090605790000204800900000004081000970400851,347569182168274593259138467612345978483792615795816234821957346534681729976423851,0.31232150003779680,46,14858,14812
417206080508070042300400007000700008270000031800004000600003004940080103050901826,417236589568179342329458617135792468274865931896314275681523794942687153753941826,0.23585529997944832,45,10921,10876
100207005302010408570000031003705900405090307000823000700000003030681050856372149,148237695362519478579468231213745986485196327697823514721954863934681752856372149,0.16091929998947307,40,7364,7324
200137009167080423000000000410306078653010942090425030000000000030070060076802310,245137689167589423389264751412396578653718942798425136521643897834971265976852314,0.03099469997687265,42,632,590
000258000460070083500000007030000090246090875908040201091000740003010900854967312,317258469462179583589436127135782694246391875978645231691523748723814956854967312,0.03475809999508783,41,819,778
400356189109000007500000000300700594604015823800400671900000000208000005700839412,427356189169284357583197246312768594674915823895423671931542768248671935756839412,0.05671919998712838,42,1925,1883
207356108108090306300000007000603000586020731700080002800000005024010680670839014,247356198158297346369148527412673859586924731793581462831462975924715683675839214,0.09354849997907877,41,3786,3745
206300091048200007309040050400068000682093504700012000501020030027600005804900026,256387491148259367379146258413568972682793514795412683561824739927631845834975126,0.03525580000132322,42,878,836
230456018158020476460080053300208009504010807600000004000090000005060300840030092,237456918158329476469187253371248569594613827682975134713892645925764381846531792,0.09936110000126064,42,4090,4048
250360091067280004309040006500003000743016508800002000901030005078520003430790012,254367891167289354389145276512873469743916528896452137921634785678521943435798612,0.05476859997725114,40,1762,1722
305208609200050008498060125000506000807090203960000014001030900040080050780615032,315248679276159348498367125134526897857491263962873514521734986643982751789615432,0.03443439997499809,41,872,831
300248009206050308498000125130506097807090203900000004000734000040080050780010032,315248679276159348498367125134526897857491263962873514521734986643982751789615432,0.03581989998929203,41,990,949
216438009007250108500000000600080405403506812900020607700000000004960701169875004,216438579347259168598617243621783495473596812985124637752341986834962751169875324,0.06200589996296912,40,2181,2141
253647809000000274470002000300060095600905103700010068520006000000000687846791502,253647819168359274479182356312468795684975123795213468527836941931524687846791532,0.05079160002060235,40,1668,1628
201359478080100030703000050124005007300908601896001005407000080030700060602894713,261359478589147236743286159124635897375928641896471325417563982938712564652894713,0.03286430001026019,38,780,742
306200840020450760400800102013007580600523007097008230800900405040380690905700320,356271849128459763479836152213697584684523917597148236831962475742385691965714328,0.02042009995784611,38,146,108
057306029100000057200007000010005700570148032004700010000500008630000005740802390,457316829163289457289457163312695784576148932894723516921534678638971245745862391,1.00301169999875128,46,48679,48633
006305789430190056500000004000002005090418020800900000300000008750069013984701500,216345789438197256579286134143672895695418327827953641361524978752869413984731562,0.05883300001733005,44,2016,1972
300209750460050832000000106006000980240398560005000240000000408750040619900706320,318269754469157832572483196136524987247398561895671243621935478753842619984716325,0.08240579999983311,42,3141,3099
100047809000000420400308000030070198600924003795010040000702004067000000802650001,156247839378195426429368517234576198681924753795813642513782964967431285842659371,0.15244630002416670,46,6370,6324
401030709302090406500408003614302895720080064030050010000503000073010540050709030,461235789382197456597468123614372895725981364839654217146523978973816542258749631,0.06633020000299439,40,2426,2386
240030089150070024300208005400306007605090203093821450000000000930784062070502030,247135689158679324369248175412356897685497213793821456526913748931784562874562931,0.09135540004353970,40,3658,3618
105389706006000500200507003450603097001000300063070250017020630024030970809706402,145389726376142589298567143452613897781295364963478251517924638624831975839756412,0.02016390004428104,39,120,81
157040368308000402400308001270080039080000040094713820700534006035020710000901000,157249368368157492429368571271485639583692147694713825712534986935826714846971253,0.02456019999226555,40,319,279
247090186058000430300108007470080065000901000003070800800562003920734018006809500,247395186158627439369148257471283965682951374593476821814562793925734618736819542,0.02446729998337105,40,308,268
105678209000000000208504607400090003003801900080362040600050008014020750709486301,145678239376219584298534617421795863563841972987362145632157498814923756759486321,0.05780619999859482,41,1994,1953
100249308000100002409300001201085039080602147604013025702500006000800004800971203,157249368368157492429368571271485639583692147694713825712534986935826714846971253,0.02938530000392348,39,574,535
260000038000802000380070015410000097090705040003149600540203076800010004907654801,264591738175832469389476215412368597698725143753149682541283976826917354937654821,0.04362399998353794,41,1286,1245
231050798057108460400000001000609000670201039009040600510803046040060080806514307,231456798957128463468397251125639874674281539389745612512873946743962185896514327,0.03139489999739453,39,713,674
307054089000069037600300024700543000000000000000712003460001005970820000180470206,317254689248169537659387124721543968534698712896712453462931875975826341183475296,0.03339580004103482,45,728,683
305217408000000035109050006402063000000902000000180203600030907930000000804729301,365217498278496135149358726412563879583972614796184253621835947937641582854729361,0.39885649998905137,45,18995,18950
204009005000080029300100047510648000040201060000753014420007006970060000600900802,264379185157486329389125647512648793743291568896753214421837956978562431635914872,0.03829340002266690,45,1021,976
250369078000000000370102094080643020642090853000080000400000007026000940937814562,254369178169478235378152694581643729642791853793285416415926387826537941937814562,0.02537220000522211,40,373,333
371459028000023497200000000003076000029508743005094000400000000000041572957682014,371459628568123497294867135143276859629518743785394261412735986836941572957682314,0.02195010002469644,40,174,134
065217098208000035000050006402063009583900014706084003000030007907000082054729061,365217498278496135149358726412563879583972614796184253621835947937641582854729361,0.04897149995667860,39,1544,1505
009178243102000089000000007206037805357890020908012706000000008704000052005724361,569178243172345689483269517216437895357896124948512736621953478734681952895724361,0.02379850001307204,39,287,248
200501008100497006070020050001070200400010009093080540000208000904103807835769412,246531798158497326379826154561974283482315679793682541617248935924153867835769412,0.03081450000172481,41,621,580
240305600108000432000080105000036008600509003500870000704020000925000807006704021,247315689158697432369482175471236598682549713593871264714928356925163847836754921,0.11668030003784224,45,4960,4915
006209587208107300009080000002060908680790205003050401001070000805406700007503842,146239587258147396379685124512364978684791235793852461421978653835426719967513842,0.02329119999194518,41,294,253
020306490138209507040070010400000003075931600900000001050060030392807106060103270,527316498138249567649578312416785923275931684983624751751462839392857146864193275,0.03849949996219948,41,1040,999
000307000309020407478050312100000008000702000697010523010273080700080004806495201,251347896369128457478956312142539768583762149697814523914273685725681934836495271,0.22480530000757426,41,10195,10154
060307040209468301504000608000000000400702006697010423001070800700986002806241907,168357249279468351534129678312694785485732196697815423921573864743986512856241937,0.02506529999664053,40,388,348
230508019015030260800010004900374005400105007587602431000726000300000006609040102,234568719715439268896217354921374685463185927587692431148726593372951846659843172,0.02124610001919791,40,153,113
100200060250069704069078102520000006480502309790000005072041503810053607900700040,147235968258169734369478152521397486486512379793684215672841593814953627935726841,0.02717820001998916,39,459,420
247108000300400007109300500700000859400205001596000002001003908900007005000906143,247158396358469217169372584712634859483295761596781432621543978934817625875926143,0.08166480000363663,45,3191,3146
158200006009080107403060002300490005004000600700053009800030704605070900900001863,158247396269385147473169582316498275594712638782653419821936754635874921947521863,0.06065230001695454,45,2124,2079
467209358100080009598000124010000090300108002906030705800060007003020900709841206,467219358132584679598376124214657893375198462986432715821963547643725981759841236,0.05203299998538569,40,1708,1668
317408962208000503509000408120070095604000107005020600800942006002010300900503001,317458962248169573569237418123674895684395127795821634831942756452716389976583241,0.02963130001444370,41,536,495
217348956000060000409207108070000060504080301006090500601904805003070200740801093,217348956358169742469257138872513469594786321136492587621934875983675214745821693,0.04743159998906776,40,1429,1389
210300098007090400400000310600070050804915203090080004032000007005020900960001042,216354798357198426489267315621473859874915263593682174132549687745826931968731542,0.07117120001930743,46,2672,2626
150368079006109500009070100510080094603412807000050000000706000700524001460000023,154368279276149538389275146512687394693412857847953612921736485738524961465891723,0.03046700003324077,43,586,543
200408009108069000069000008380070014514392706970010032021000005703085000800601003,237458169158269347469137258382576914514392786976814532621743895743985621895621473,0.03535150003153831,41,885,844
260147059070309080000000000020406030300792001609010702900604008700020004846070123,268147359471359286593268417127486935354792861689513742912634578735821694846975123,0.02448110003024340,42,285,243
340018009000309148189000200710090002800154607690020004431000700000506481560041003,346218579257369148189475236714693852823154697695827314431982765972536481568741923,0.04906069999560714,39,1565,1526
140206039068104520270000046080060010601020308700901004814030692500010003900040001,145276839368194527279358146482763915691425378753981264814537692527619483936842751,0.03735489997779950,40,973,933
100479068060100507200060403014005000700000005000700320501080004903001080680342001,135479268468123597279568413314295876792836145856714329521987634943651782687342951,0.05331510002724826,45,1746,1701
200583017170000504309100000002300000500219008000006100000004809704000061980621003,246583917178962534359147682412358796567219348893476125621734859734895261985621473,0.04418550000991672,46,1316,1270
106258903057000260200060001030572090700496005000000000570020089609080402020931050,146258973357149268298367541431572896782496315965813724573624189619785432824931657,0.03895509999711066,42,1036,994
140235690302009048000486002200347000437000006900612000000854009703001064890763250,148235697362179548579486312216347985437598126985612473621854739753921864894763251,0.03158549999352545,37,613,576
051437980068000140400168005016000490800000001900814002700040003690080014040672050,251437986368259147479168235516723498824596371937814562785941623692385714143672859,0.05697029997827485,41,1947,1906
005006147040000009009107008076480000402070506000012470700503800800000020964800700,285936147147258369639147258376485912412379586598612473721563894853794621964821735,0.41265670000575483,46,19667,19621
235798106008000239400003508000860000640100023000930000500007904004000765867549302,235798146178456239496213578351862497649175823782934651513627984924381765867549312,0.02050969999982044,40,150,110
106358090500000108008017063300500009060800700705604001400900806002085000003146950,126358497537469128948217563314572689269831745785694231451923876692785314873146952,0.53285000001778826,43,26549,26506
146357280000000063308400700010030807080071640700000000601000000900008506875290310,146357289257189463398462751412635897583971642769824135621543978934718526875296314,0.06212570000207052,44,2078,2034
316240708480000053509308004030400500600000029708500001050010300004000015103007002,316245798487196253529378164231489576645731829798562431952614387874923615163857942,0.73760369996307418,45,36394,36349
137480600008070010400102508300050090084093000700806203020040000000001002576920400,137485629258679314469132578312754896684293157795816243821347965943561782576928431,0.67179819999728352,45,32932,32887
357008269060050730409000005270000403003090070600307000010930000005026001900070308,357148269168259734429763815271685493583492176694317582812934657735826941946571328,0.11045699997339398,46,4659,4613
157300200000510000309200401000450890500000074790100005830000000000001048645892700,157364289428519637369278451213457896586923174794186325831745962972631548645892713,0.72230969998054206,46,35332,35286
007300109000049020000200403410560800680001000700804001530980674000617008870405902,247356189358149726169278453412563897683791245795824361531982674924617538876435912,0.02840339997783303,42,525,483
100300509000070040004200003400020800807000030263007001610030980005091026970502304,126348579539176248784259163451623897897415632263987451612734985345891726978562314,0.11765559995546937,45,4944,4899
140000300376080050098300601710400503050070040900000807420000900501000086089703104,145267398376189452298345671712498563853671249964532817427816935531924786689753124,0.10359700000844896,44,4335,4291
310200790080090050009008164200400000045730029708500001950010300004000015163807002,316245798487196253529378164231489576645731829798562431952614387874923615163857942,0.02566899999510497,43,388,345
100368209070000800009407016720506100060070040504001007010700900008090721900802003,145368279376129854289457316723546198861973542594281637612734985438695721957812463,0.06027610000455752,44,2089,2045
300156409000230607009007012200604000080970200604008075000860504000001063906043001,327156489418239657569487312275614938183975246694328175731862594842591763956743821,0.05210669996449724,43,1660,1617
200040903060200504071093068120609705090310000600005009010700806705000400800001007,258146973369278514471593268123689745594317682687425139912734856735862491846951327,0.08984630001941696,45,3515,3470
107008069000100200209040051400503002080710006003804005704030008010000003005002614,147258369358196247269347851471563982582719436693824175724631598916485723835972614,0.46772529999725521,46,22482,22436
200703409360050200009000053120306705030090000900504001610800907700040080005002306,258713469361459278479268153124386795536197824987524631612835947793641582845972316,0.04091670003253967,45,1096,1051
350408792270900600009030051500100908080070000607002004710600409800090020006001037,351468792278915643469237851523146978184379265697582314712653489835794126946821537,0.07308680005371571,44,2697,2653
150008403400030520380009067270310005040090000503006004600900802005040000038605001,157268493469137528382459167276314985841592376593786214614973852725841639938625741,0.04635040002176538,45,1386,1341
358207009100050380470001050200500008080070030706003405800000004000020060635104072,358267149162459387479381256213546798584972631796813425827635914941728563635194872,0.20045010000467300,45,9106,9061
100208309480350100050060040200000003730690480048703062570020904000070020004005817,167248359482359176359167248216584793735692481948713562571826934893471625624935817,0.04055010003503412,42,1069,1027
100204368320100000069038070200600000070380000900002043630900804040010900805063712,157294368328176495469538271213649587574381629986752143631927854742815936895463712,0.02576779999071732,43,335,292
547109208100000507060000040200003004470500800800427315680700009030000100904001723,547169238129348567368275941215893674473516892896427315681732459732954186954681723,0.03434829995967448,43,817,774
007049065200100703560070140402097000003400900705000080000006008020010500904053621,137249865248165793569378142482597316613482957795631284351926478826714539974853621,0.08347449998836964,45,3230,3185
107238059300100400200050080502000008476000300003002046600500804700900205085620731,147238659358169427269457183512346978476895312893712546621573894734981265985624731,0.02224479999858886,42,198,156
108507029000000407470030051003085096500000000600900040701094005840016900036052174,168547329352169487479238651213485796594673218687921543721394865845716932936852174,0.03726630000164732,42,957,915
006007095108600403300580026407008009000100700005070061001002007030940600984050012,246317895158629473379584126417268539623195784895473261561832947732941658984756312,0.04058859997894615,44,1127,1083
407085093100300007500070410001008065306051708005900000600503009030000100052807634,467185293129346587583279416241738965396451728875962341614523879738694152952817634,0.11748160002753139,43,5040,4997
207038069000200437060400280071000005400500600805970000702603058904800700080790014,247138569158269437369457281671324895493581672825976143712643958934815726586792314,0.02826240001013502,42,503,461
305079218260300705100250406001007009602000007000080000500702003800900500937840020,345679218268314795179258436481527369652193847793486152514762983826931574937845621,0.02200820000143722,44,207,163
003409067400100082000270004005008010164900008790010000600004025847305600000860070,213489567476153982589276134325648719164937258798512346631794825847325691952861473,0.02983539999695495,45,607,562
305001096000309402200050100001000008400108905096740020608907034720500000054860010,345271896167389452289456173531692748472138965896745321618927534723514689954863217,0.02076179999858141,43,178,135
206048759007009208580070100362007090000600002010020500601004005790005600050060317,236148759147359268589276143362587491475691832918423576621734985793815624854962317,0.09798840002622455,43,3937,3894
138000079007508061560130008001025090400600103090080020800002004704900600010800732,138246579247598361569137248371425896482679153695381427853762914724913685916854732,0.02573140000458807,43,389,346
247300091000209006360000500003001060600700105001620000402007008930800400070514230,247356891158249376369178524593481762624793185781625943412937658935862417876514239,0.02034010004717857,45,115,70
007230498000169007530087100040010070300500801090600000602003785700001004984000310,167235498428169537539487126245318679376592841891674253612943785753821964984756312,0.04192599997622892,43,1140,1097
007030680308109502560700000120046090406000305780000100001000058052600000874500061,217435689348169572569728413125346897496817325783952146631274958952681734874593261,0.08222169999498874,44,3252,3208
107050380008000007300408100000060000605809013000030450021083094730010002890700501,147256389258391647369478125413562978675849213982137456521683794734915862896724531,0.04881539999041706,45,1564,1519
047350100000002079300108200010020000602700031090015604800007406400906002900040800,247359168158462379369178245514623987682794531793815624821537496435986712976241853,0.10384390002582222,46,4315,4269
007256080058001047300400105010060070600809003900100400001080000730915000806700531,147256389258391647369478125413562978675849213982137456521683794734915862896724531,0.06736240000464022,44,2538,2494
108040090004159078300260000010070000903006005080900200031020080840001003690800124,158347692264159378379268451416572839923486715785913246531624987842791563697835124,0.33024729997850955,45,15689,15644
317058460008039057509400300000040800280601034600000005001075042700906000850300900,317258469468139257529467318173542896285691734694783125931875642742916583856324971,0.02585629996610805,43,409,366
207359160008002079300170200014020080602704001700000604021000006030906002970200803,247359168158462379369178245514623987682794531793815624821537496435986712976241853,0.04251060000387952,42,1205,1163
018046070007009082560200104370080000105003207040000003051002008000004005790800301,218346579437159682569278134372481956185693247946527813651732498823914765794865321,0.20174940000288188,46,9347,9301
005060380008029016300108007013290750586700003090000104002840005000002000870605902,125467389748329516369158427413296758586714293297583164932841675654972831871635942,0.02675049996469170,43,449,406
007050280308092076260100405470030090502901007600000502700020000000703004830600700,147356289358492176269187435471235698582961347693874512714528963926713854835649721,0.05173270002705976,45,1685,1640
375028400000000038100306000040070850607004003810200600000763004004802005780000301,375128496462597138198346572243671859657984213819235647521763984934812765786459321,0.15272760001244023,46,6828,6782
348090276002007490500204008010040709003900042097800001020030000004018020750009013,348195276162387495579264138215643789683971542497852361821736954934518627756429813,0.24312709999503568,43,11402,11359
158370600060000040009002003320700098004021006000000001030010900045006087716049002,158374629263198745479652813321765498584921376697483251832517964945236187716849532,0.02631420001853257,46,441,395
146230590200000047379008602000010000400090080805706003020001800007004035684305071,146237598258169347379458612762813459431592786895746123523971864917684235684325971,0.03510219999589026,42,819,777
007130508158240060309057002010070809500003000703400005020764900004008020900300486,247136598158249367369857142412675839586913274793482615821764953634598721975321486,0.07305280002765357,42,2752,2710
100250369300090070609300108210080500504020080800009002481000000030005046905703801,147258369358691274629374158213486597594127683876539412481962735732815946965743821,0.06157009996240959,43,2086,2043
250100409360000002479008501120090700084030016007004005000000000005006087746501003,258167439361459872479328561123695748584732916697814325812973654935246187746581293,0.31178420002106577,45,14573,14528
400100692030060000208009003670300805002070010004601007010000000025006034906750201,457138692139267458268549173671392845382475916594681327713824569825916734946753281,2.36344100005226210,46,117993,117947
130200607000000348409000005390601574602480030700005002020000000073006020906802703,135248697267159348489763215398621574652487139714935862521374986873596421946812753,0.26492380001582205,44,12137,12093
130420597457010000000000008310600009006190040800703002620000000003005021905261304,138426597457819236269537418312648759576192843894753162621374985743985621985261374,0.06711780000478029,44,2376,2332
400200701020049000500000032060008570000090048804702103910070300708003025603820917,436285791127349856589167432261438579375691248894752163912576384748913625653824917,0.10121019999496639,42,4272,4230
210300509050000420000008173020000005006081034000503001030840900042035010705619042,217364589358197426469258173123476895576981234894523761631842957942735618785619342,0.15367470000637695,43,6674,6631
200301690060089040300006002500100800610098037708603001070960500052004010906800024,245371698167289345389456172523147869614598237798623451471962583852734916936815724,0.04746580001665279,42,1466,1424
300170205720000609100000004230400900000080123007002006510690807003001060604725091,346179285728534619159268734231456978465987123897312456512693847973841562684725391,0.07257160003064200,43,2691,2648
300108260100000070400250081200476008086090020790502003030000900002005036805903142,357148269128639475469257381213476598586391724794582613631824957942715836875963142,0.02050500002223998,42,96,54
200136589150000600000070200401785096080040050700001002004800000036010928802000431,247136589158294673369578214421785396683942157795361842914823765536417928872659431,0.10301869997056201,43,4257,4214
247139056100064309000050002503901024080520007600003001900305000725000010806000005,247139856158264379369857142573981624481526937692743581914375268725698413836412795,0.02247350005200133,43,218,175
240308509130000406800060070300207905070090600000004007700900802920050761005002094,246378519137529486859461273361287945472195638598634127713946852924853761685712394,0.05443489999743178,44,1827,1783
230100098400080307000070020103000000070500810805013046310900400900860730008000062,237154698461289357589376124123648579674592813895713246316927485942865731758431962,0.04276659997412935,46,1235,1189
258000076160000300000096080400007005010400038003085002500900007830710509907002060,258341976169278354374596281482137695615429738793685412521963847836714529947852163,0.08167660003527999,46,3208,3162
372140009180200304400050000003001005000690200809027036500700000640030700007815042,372146589185279364496358127263481975754693218819527436521764893648932751937815642,0.02766749996226281,44,450,406
246007009100200300370168040402003608000000000097012004601705003720800006905020080,246357819158249367379168245412573698563984172897612534681795423724831956935426781,0.35188579995883629,44,16239,16195
300406009200100607000070001102004003680510000005087006700605408930800765006040130,317456829248193657569278341172964583683512974495387216721635498934821765856749132,0.02419359999476001,44,275,231
208307506600590100009160270140603809763080000000020007400200905501009040006800021,218347596674592183359168274142673859763985412895421367487216935521739648936854721,0.03025259997230023,42,561,519
107049086200100409000580001302705008000000000004031007923400005740900060605072090,137249586258167439469583721312795648576824913894631257923416875741958362685372194,0.04720010003075004,45,1418,1373
201307806300009500000068040003004905000500023095000084010800009034706008056000031,241357896368429517579168342123684975487591623695273184712835469934716258856942731,0.47620219999225810,46,22774,22728
256000089100500006000080000312008705500000308000065042600903074037800001005071920,256137489178549236493286517312498765564712398789365142621953874937824651845671923,0.17964210000354797,45,7701,7656
105006089270100300080050000007008062500004801028015003701900008960800400004061090,145236789276189354389457126417398562593624871628715943751942638962873415834561297,0.05418219999410212,45,1816,1771
137204509200170300400085010000000001310000608792016035021400053003500006805000040,137264589258179364469385217586943721314752698792816435621497853943528176875631942,0.15513689996441826,43,6678,6635
147000085250009706060070000000300679003400002086090041030804007020000500705023418,147236985258149736369578124412385679973461852586792341631854297824917563795623418,0.06525679997866973,44,2243,2199
056008293100025708200030050001007049500100607004090032000950004820300900047061020,456718293139425768278639451361287549592143687784596132613952874825374916947861325,0.04959160002181306,43,1549,1506
007036085200009006000070100012080079900400002006000041601800007820000500795623418,147236985258149736369578124412385679973461852586792341631854297824917563795623418,0.02452989999437705,44,340,296
007005869100009407060080000001020083000900206690070054004002008820700600930041720,247135869158269437369487512471526983583914276692378154714652398825793641936841725,0.03321059996960685,45,733,688
000008069300100802200300740400082607706401003009030000001804006000006504670950020,145278369367149852298365741413582697756491283829637415531824976982716534674953128,0.02041179995285347,46,73,27
007008061100009304060070000012000057700500109985010032501406003670900500890035210,247358961158269374369174825412893657736542189985617432521486793673921548894735216,0.02854229998774827,42,511,469
000108029300009006190270000006000080405800001930500064001000005703905600859020743,567138429382459176194276358216394587475862931938517264621743895743985612859621743,0.12541109998710454,45,5381,5336
007348096500100003000050041401070059300005607060910002003001000200506700900030125,127348596548169273639257841481672359392485617765913482853721964214596738976834125,0.16448119998676702,45,7428,7383
206400019107309048000127005700000000800000506090780102301005090970602400560070820,236458719157369248489127365712536984843291576695784132321845697978612453564973821,0.05388990003848448,43,1861,1818
047006098108009076060080400002090040800605002090270500001050000600802000780964231,247536198158429376369187425512398647873645912496271583921753864634812759785964231,0.11121509998338297,44,4655,4611
000040098008009760060500042070680005502407306680290000801730009900801000040950801,217346598458129763369578142174683925592417386683295417821734659935861274746952831,0.05151509999996051,43,1661,1618
050000379300100245407300008010040690604507003730810002105000034900600001040000706,251468379386179245497325168518243697624597813739816452165782934972634581843951726,0.03244700003415346,44,703,659
040050098300009017200108403001090080602001509090080100063000000904805000520006801,146357298358429617279168453431592786682741539795683124863214975914875362527936841,0.26088340004207566,46,12149,12103
010320598200596047500100000042070800603005072790004613000000004900000005050700301,416327598238596147579148236142673859683915472795284613327851964961432785854769321,0.05417049996322021,45,1750,1705
000056398008009047300470105501040060406003002070090403003002054700501006980000200,247156398158329647369478125531247869496813572872695413613982754724531986985764231,0.03397649998078123,44,776,732
140230987000070060300008000010040000024001008803600405002900871900702003780300200,146235987258179364379468152517843629624591738893627415432956871961782543785314296,0.09870599996065721,46,4011,3965
358170629009030070400506000010040907600017003500002100020053000805009041900700502,358174629169238475472596318213845967684917253597362184721453896835629741946781532,0.03272610000567511,44,754,710
060180394407320080900406002020030760000001005800004210001060030002003057700800600,265187394417329586938456172124538769376291845859674213541762938682913457793845621,0.04747009999118745,46,1439,1393
040350809208000070300200005431020000002903068000005200700000984604001003890734600,147356829258149376369287145431628597572913468986475231713562984624891753895734612,0.02290639997227117,45,221,176
410350802208090050500408007172043000304001075090000300021030904900004008740200500,417356892238197456569428137172543689384961275695872341821735964953614728746289513,0.07659030001377687,43,2964,2921
540820309000079040300105000180050600003060002690000003700002980905601004836790500,541826379268379145379145268182453697453967812697218453714532986925681734836794521,0.02592109999386594,44,366,322
140530209200060073360001005410053700000004002800020354000040907004002036730800400,147538269258469173369271845412653798573984612896127354621345987984712536735896421,0.18512280000140890,44,8495,8451
040260305000080090300407002410020600006005004708340251070000900900804006854600703,147269385562183497389457162415728639236915874798346251671532948923874516854691723,0.03261900000507012,44,751,707
030270904007090050500406002410060528005001093080000107000050000704002001860307205,136275984247198356598436712413769528675821493982543167321654879754982631869317245,0.11577560001751408,45,4836,4791
230548197000000020150206003010080700005307008700602300500060000903004001680750932,236548197847139526159276483312485769465397218798612345521963874973824651684751932,0.05220690002897754,43,1765,1722
147060090300109006069078000000003087800400903090080040901007054400010870786004039,147265398358149726269378415514693287872451963693782541921837654435916872786524139,0.14087040000595152,43,6104,6061
240710308000000740009408002010380400000024001800590200020030000907006025680972100,246719358158263749379458612512387496793624581864591273421835967937146825685972134,0.03726459998870268,45,963,918
240130609068270400000408000400080063302050001600041270000000800004003057956807004,247135689168279435539468712471982563382756941695341278713524896824693157956817324,0.04427010001381859,44,1324,1280
251463709060070200009508030000080400000000023600004008902050804735800062806000001,251463789368179245479528136123685497584917623697234518912356874735841962846792351,0.06216640002094209,45,2178,2133
305678402700120000000005087020000000030080014009007035670830509903054021104000003,315678492748129356296345187421593768537286914869417235672831549983754621154962873,0.11524089996237308,44,4718,4674
300256709069070000572004006230060508456000000807003000013720000904000057700640001,348256719169378245572194836231467598456982173897513462613725984924831657785649321,0.39363429998047650,44,19405,19361
250307000430060020600258001100506080080090314307004002810000549703005060900000003,251347896438169725679258431124536987586792314397814652812673549743925168965481273,0.04040749999694526,44,1153,1109
305208700027690000400007026270000604080000070904006038510830460702000080806901003,365248719127693845498157326271385694683419572954726138519832467732564981846971253,0.07448149996344000,43,2949,2906
250104609376520100400008025100000000080000517700001063830010940501060030900800701,258134679376529184419678325123756498684392517795481263837215946541967832962843751,0.10939449997385964,43,4630,4587
350200700000090050470008020200005008687012034590004071740800305002000047830009002,356241789128397456479568123214735968687912534593684271741826395962153847835479612,0.04764270002488047,44,1413,1369
204300609060149000000200034400680000820091705006003002700805406000010087948006051,214358679367149528589267134475682913823491765196573842731825496652914387948736251,0.12094339996110648,43,5304,5261
251308007060100003300060040100780506570093401680000072700020650825000010900001038,251348967467159823398267145134782596572693481689415372713824659825936714946571238,0.02219990000594407,42,258,216
210309056450100020000050019300006004740000105506002003120600807830000040967004031,218349756459167328673258419391576284742983165586412973124635897835791642967824531,0.03882529999827966,43,1077,1034
914006007350100204608030090100600009240090500009004003400800906000040030893065410,914256387357189264628437195135672849246398571789514623471823956562941738893765412,0.07000060001155362,44,2637,2593
107068009000100000209057010300800004080270900604003072710900506000030090946085020,157368249468129735239457618372896154581274963694513872713942586825631497946785321,0.33024989999830723,45,15395,15350
201007609468130000000000030300604908020090700007005003100903507000010000786500391,231457689468139275579268134315674928824391756697825413142983567953716842786542391,0.24923710001166910,46,11492,11446
300046008408100300000070024000502007090780401003000002600904785970010003845007019,317246598428159376569378124184562937296783451753491862631924785972815643845637219,0.06387449998874217,44,2339,2295
405008209120300500000056040200003097750000600084017002500820004800000020692034015,465178239128349576379256148216583497753492681984617352537821964841965723692734815,0.01961850002408028,44,97,53
107246009200300000060050007001405002590780604084000053700500060825030900906001025,137246589258397146469158237371465892592783614684912753713529468825634971946871325,0.20174170000245795,43,9213,9170
257009008100400009049070060006003007030000801005004006501900604080540000674021093,257369418168452739349178265416283957732695841895714326521937684983546172674821593,0.53854039998259395,45,26254,26209
308027409100409008000080010200005807080900602003070145720603904930010700006700051,358127469162439578479586213214365897587941632693278145721653984935814726846792351,0.02101820003008470,42,116,74
453067090100200000079050060300004009090306204084020017921803000730600900006000030,453167892168239475279458163312784659597316284684925317921873546735641928846592731,0.02746020001359284,45,472,427
235107009140060207079080100000006002080590301002003064800004000920000000504901028,235147689148369257679285143351476892486592371792813564817624935923758416564931728,0.10408799996366724,45,4297,4252
207000039300204000069087000000008692500000703093020005010605028700010906806003071,247156839358294167169387254471538692582469713693721485914675328735812946826943571,0.13703790004365146,45,5973,5928
047009080100400007083760190306504009020100803000020051601005008932800600804070012,247319586169458237583762194316584729425197863798623451671235948932841675854976312,0.04281900002388284,42,1255,1213
246007083150000002009028100000004059400000600097060000804502096920600300760040021,246157983158396472379428165631784259482915637597263814814532796925671348763849521,0.05581390002043918,45,1884,1839
106035089300409001090060000000004008810000205005010040401028007650903000789040523,146235789327489651598167432263754198814396275975812346431528967652973814789641523,0.10000110004330054,44,4084,4040
368001579100809002500060008203008005480000900605023010000000006700900301956034080,368241579174859632529367148213498765487615923695723814831572496742986351956134287,0.20251730002928525,44,9181,9137
010050020090026005050009310020030078500800102080007034801002097700900850065083041,416358729397126485258479316124635978573894162689217534831542697742961853965783241,0.02901460003340617,43,531,488
147030080200109003060000000003597026570600001000010050631040098920003400004020065,147236589258179643369458172413597826572684931896312754631745298925863417784921365,0.02488399995490909,45,331,286
301000080207300004480150200000907500600510803508040000702435008930800400800020315,351274689267398154489156237123987546674512893598643721712435968935861472846729315,0.03373250004369766,43,738,695
207064050100009004060385002010090007300840005090702000901030070600000409045020831,237164958158279364469385712514693287372841695896752143921438576683517429745926831,0.05225469998549670,45,1728,1683
107008095200009007060000000401020006380906100690050430703000084820000609056084723,137468295248519367569237841471823956385946172692751438713692584824375619956184723,0.02935530000831932,43,562,519
106290048300008006080000000237004050800000160560000000605802093720041605048035710,156297348379418526482356971237164859894523167561789234615872493723941685948635712,0.02946829999564216,43,510,467
100036090058004007260007010401080070570301002090000300603000059720009800980073104,147236598358194267269857413431982675576341982892765341613428759724519836985673124,0.05168610002147034,44,1683,1639
040320580008009007300400602032090070000704006690200450900002060800900200700653198,146327589258169347379485612432596871581734926697218453913842765865971234724653198,0.03374949999852106,44,802,758
257060090061009008490300006020080030603094001980003700500070063800500900740900280,257168394361429578498357126124785639673294851985613742519872463832546917746931285,0.05308129999320954,44,1789,1745
340210060009057000570300104000070030250004001600000200004020386800706009900840752,348219567169457823572368194491572638253684971687193245714925386825736419936841752,0.02905830001691356,45,580,535
040326059008000007269507004070030020002001073600000500000050742900708600730260108,147326859358149267269587314471835926582691473693472581816953742924718635735264198,0.03160749998642132,44,652,608
046310080150000300300406007010060030900000005700000200501870690800601700600543810,246317589157289346398456127412765938963128475785934261531872694824691753679543812,0.05034770001657307,46,1577,1531
010340089008069002460208531030010060000902047704600200000030090900700000600894123,217345689358169472469278531532417968186952347794683215821536794943721856675894123,0.04949389997636899,43,1563,1520
060230489008009007400008003280050076600001002700600100002000630900810004540300891,165237489328149567479568213281453976694781352753692148812974635936815724547326891,0.15602429996943101,45,6781,6736
460037050070049020500068307210070860007000005849000200001950080900700100700320504,468237951173549628592168347215473869637892415849615273321954786954786132786321594,0.03817640000488609,44,1030,986
030270810000040265500000007380050020007003008600800104712080000900001002860930501,436275819179348265528196347381459726247613958695827134712584693953761482864932571,0.17388689995277673,46,7750,7704
040360590000009306360005027080000960020093084703000010402006850800000431900810602,247361598158279346369485127584127963621593784793648215412736859876952431935814672,0.06072479998692870,43,2066,2023
250160390001009070408000106020080009603004001985603702009070060800500017740900205,257168394361429578498357126124785639673294851985613742519872463832546917746931285,0.03166560002136976,42,694,652
150247830000050260400000105830090700000072008267000901603920080005000093900730602,156247839379158264482369175834591726591672348267483951613924587725816493948735612,0.13690760004101321,43,6002,5959
060107405009040863003009002302000900080070016607003004000500608904000051850320709,268137495179245863543689172312456987485972316697813524721594638934768251856321749,0.06439810001756996,44,2321,2277
100006709200080145409007026610000507098670000004001038500000200000050060807403901,135246789276389145489517326612834597398675412754921638563198274941752863827463951,0.07564009999623522,45,2852,2807
130409078400370169209608003380700600000030000507000002800100920010000006905867001,136459278458372169279618543381724695692531784547986312863145927714293856925867431,0.18603529996471480,44,8274,8230
190274008400080009250096000603000702000030860809000035300805906700010080905607013,196274358437581629258396147613458792524739861879162435341825976762913584985647213,0.07506930001545697,43,2867,2824
140300002000410637009087014501800200000050009602074008910508000005030001806740905,147365892258419637369287514571893246483652179692174358914528763725936481836741925,0.17158460000064224,43,7632,7589
300106005108070620060050100602000009080790000705080014500000438006045791970803500,347126985158479623269358147612534879483791256795682314521967438836245791974813562,0.04137599997920915,43,1168,1125
200001009100090307360408020500700008090080000702004063620030904000027806805609231,247351689158296347369478125513762498496583712782914563621835974934127856875649231,0.07405409996863455,43,2817,2774
301200007460100500079000000120007806080510300007006014700000465900000081846701932,351248697468179523279365148123497856684512379597836214712983465935624781846751932,0.16072279994841665,43,7123,7080
008009367300200090470000082105004009700000500003007020000703908800920706690085030,258149367361278495479356182125634879746892513983517624512763948834921756697485231,0.13630940002622083,46,5826,5780
207100089600003204000280016100005008500600400006002030820907045004000820765020193,247156389618793254359284716172345968583619472496872531821937645934561827765428193,0.06788190000224859,43,2490,2447
365201089120300000070560032203000006050980001097020053500000008046000007782609014,365241789128397645479568132213754896654983271897126453531472968946815327782639514,0.13114489999134094,42,5662,5620
007002069100307000008000030401289006600034701590076020700603005000940600930050410,347812569159367248268495137471289356682534791593176824714623985825941673936758412,0.04388449998805299,44,1285,1241
300467009400009003500000470185006904290000700007910035720504008934020000056090040,312467589478159263569283471185376924293845716647912835721534698934628157856791342,0.02913529996294528,43,548,505
300126085108409003200050140010004809480701200005080010000000008830240700974800060,347126985158479623269358147612534879483791256795682314521967438836245791974813562,0.02553479996277019,43,389,346
408007359100005700050090140001000062580000400604072030000008004920040607846050010,468217359139465728257893146371584962582936471694172835713628594925341687846759213,0.21337710000807419,45,9773,9728
207038061100009402300120050000056829680400300003080040700002003920840600036000090,247538961158679432369124758471356829682491375593287146714962583925843617836715294,0.04135249997489154,44,1190,1146
201007689360100402000280153005000006730502804004060020000800007600900300890071045,251347689368159472479286153125498736736512894984763521512834967647925318893671245,0.13344790000701323,43,5670,5627
107008359200700006450100000302004005500872600004010070000905208820000704946080530,167428359238759416459136827372694185591872643684513972713945268825361794946287531,0.06215959996916354,43,2133,2090
006057091100400002000000004002003057300701408000040130001930005930070210857010043,246357891173489562589126374412893657395761428768245139621934785934578216857612943,0.24380850000306964,45,11280,11235
005026479200009008000500100302000001504600207978010030000437805750800300840050710,185326479237149568496578123362784951514693287978215634621437895759861342843952716,0.03460800001630560,43,701,658
056010030100009076000500200400005002502600780637020010703050064900700008860090320,256417839148239576379586241481375692592641783637928415713852964924763158865194327,0.03530990000581369,45,793,748
057060040300417569460300000003000000670000100095026000002070984700938001080042670,157269348328417569469385712213754896674893125895126437532671984746938251981542673,0.05625149997649714,44,1891,1847
307096048200107306000000501106000059580020000704060020601050004800619005970083610,317596248258147396469238571126374859583921467794865123631752984842619735975483612,0.04642329999478534,42,1369,1327
154030086000100009379400001001020605007600048690800000042000060700900503900760010,154239786268175439379486251481327695527691348693854172842513967716948523935762814,0.07540150004206225,46,2844,2798
054060010108009073300100204001070382003521907790480000005002000900700008030000100,254367819168249573379158264541976382683521947792483651415832796926715438837694125,0.04695069999434054,46,1421,1375
416030590257109004300400002172080935003090001000010006900003070500800000760920450,416238597257169384389457162172684935643795821895312746921543678534876219768921453,0.07169500004965812,43,2694,2651
240060170108000024570100603000040000006917005490800206000090057750000001084700360,243568179168379524579124683315246798826917435497835216631492857752683941984751362,0.12196459999540821,45,5050,5005
240069030000070059300400006710000890003000204900500370401050082580090043602830500,245169738168372459379485126714623895853917264926548371431756982587291643692834517,0.02280299999983981,44,230,186
016370580358000002470200601120050970007892004800700200000000020930008007700600403,216374589358169742479285631123456978567892314894713256641937825932548167785621493,0.06422080000629649,44,2250,2206
048050109079300005256700034700020500002100003590600000014000080805000006900800251,348256179179348625256719834761423598482195763593687412614532987825971346937864251,0.14367889997083694,46,6196,6150
040050900100049067209308001410007600503090004800403200600035049000000036905760802,347156928158249367269378451412587693573692184896413275621835749784921536935764812,0.08938590000616387,43,3517,3474
062370409358040000400506208090030840003087002780600500001000080905000001807900325,162378459358249176479516238296135847513487692784692513621753984935824761847961325,0.04807349998736754,43,1537,1494
063050408005103096208400003010540700007090002900702000020000847700000005809600321,163259478475183296298467153312546789547398612986712534621935847734821965859674321,0.05122739996295422,45,1629,1584
140250839058070000300408005010000090000004027000620400820005964004001002906800103,147256839258379641369418275412587396683194527795623418821735964534961782976842153,0.04121230001328513,45,1153,1108
160040830380169045402503006016000900008001024740800300020090013000030008603700402,165247839387169245492583176216354987538971624749826351824695713971432568653718492,0.02816089999396354,42,490,448
040350800350060007200008005410630509000094060806512304620000700000000002705126403,147359826358261947269478135412637589573894261896512374621943758934785612785126493,0.04180770000675693,43,1114,1071
040100706210060985009008003100600597495032010700500402630000800050040060804006009,348159726217463985569278143123684597495732618786591432631925874952847361874316259,0.02346779999788851,43,234,191
340206180150070020260008047510000000006037012703800065620000300000000001805043206,347256189158479623269318547512694738486537912793821465621985374934762851875143296,0.78183839999837801,44,39097,39053
210450609060070058507003004300080400002097815800600002100000000004020081900041203,213458679469172358587963124371285496642397815895614732126839547734526981958741263,0.11989210004685447,45,5024,4979
107280005000040060200007000470390600000001039003600004620000940734010080895704103,147286395358149762269537418472398651586471239913625874621853947734912586895764123,0.07268990000011399,45,2656,2611
257139006000060000309004105120450907506007030000300001000200000040080063805003402,257139846418562379369874125123456987586917234794328651631245798942781563875693412,0.11378700000932440,46,4680,4634
147006023050000706009000015602305008080710600095004030500900004004020080876003091,147586923258139746369247815612395478483712659795864132521978364934621587876453291,0.03108400001656264,44,619,575
352470009000090540409008001210357800003010072007804003720000900035040060800009205,352471689168293547479568321214357896583916472697824153721685934935142768846739215,0.02954319998389110,43,585,542
237100589150290060009000302300700000600030070795002003520600007070010820800027001,237146589158293764469578312312754698684931275795862143521689437973415826846327951,0.32508939999388531,44,15468,15424
103208009260000385008090000300402006520010803007000014700506900030049021906001037,153268479269174385478395162391482756524617893687953214712536948835749621946821537,0.04102240002248436,43,1129,1086
251000008060007200408000100100060902582030761607001050800400000700090013906513807,251349678369187245478256139134765982582934761697821354813472596725698413946513827,0.02230609999969602,43,203,160
100400893350000700009000025200500008070090406605000031500940680980050000700812049,127465893358129764469378125241536978873291456695784231512943687984657312736812549,0.04058700002497062,45,1142,1097
140508027000000009000029048413000002570094806906007003600803904030060000005402001,149538627258746139367129548413685792572394816986217453621853974734961285895472361,0.02914739999687299,45,546,501
247105068380070000009030047400000009070000500098000001810307006734650002065002473,247195368381476295659238147423561789176983524598724631812347956734659812965812473,0.10383340000407770,43,4257,4214
216009504058002009009060012102000705080000100007005003700600008043050000905021037,216379584358142679479568312132486795584793126697215843721634958843957261965821437,0.69100669998442754,46,33792,33746
300109802008000000000040060600007028700600900503800607420900703000081040067032591,346159872158276439279348165614597328782613954593824617421965783935781246867432591,0.21392750000813976,46,9528,9482
137508009280009500600023087306080094470306100008007002800904006740060000005000041,137548269284679513659123487316285794472396158598417632821954376743861925965732841,0.04284529999131337,43,1257,1214
147063059300501406050470100003045087700912300090007000001004600030000705000059230,147263859328591476659478123213645987785912364496837512571324698932186745864759231,0.02002870000433177,43,74,31
147030096268004007030080402325000068000000903000000004003000005750000049080056321,147235896268194537539687412325479168476821953891563274613942785752318649984756321,0.73956099996576086,46,35803,35757
508016094100209006460080200004008009280000301006005408001000005850400107070650040,528316794137249586469587213314728659285964371796135428641872935852493167973651842,0.08177320001414046,45,3210,3165
065037049400209003080450200003098002700310900090025030500903084930800700000060090,265137849471289563389456217153698472728314956694725138512973684936841725847562391,0.05777590000070632,44,2026,1982
207050068108009004360040100402003097500104823000000401000006009600900702080470310,247351968158769234369248175412583697576194823893627451721836549634915782985472316,0.02664080000249669,44,428,384
146005097200009603380060500403072089500608400090010006005003904920700008030040070,146235897257189643389467521463572189571698432892314756715823964924756318638941275,0.06478240003343672,43,2243,2200
216475093300269007470030200002007086500600700600004350000000008820510000930080010,216475893358269147479138265142357986583691724697824351761942538824513679935786412,0.07625980000011623,44,2885,2841
147003086300001702060580400001605029600700305000000001700000238920300104000040950,147293586358461792269587413471635829682719345593824671714956238925378164836142957,0.01947999995900318,45,59,14
200305098300006004460170300002009006500200809080060721000704003700801205090630010,217345698358926174469178352172489536536217849984563721621754983743891265895632417,0.02912200003629550,44,560,516
040050069208001004060740100402030098900100502000020017001004053590200806800970021,147358269258691734369742185412537698973186542685429317721864953594213876836975421,0.03931070002727211,43,1065,1022
240351089100209003080070100008007024400190506000600010500002007900710845804060030,246351789157289463389476152618537924423198576795624318531842697962713845874965231,0.03091030003270134,43,618,575
053407029200058007070030006014000002600900403080020000001002070700800605860710034,153467829296158347478239156314586792625971483987324561531642978742893615869715234,0.06791230000089854,46,2432,2386
120340970007090040400207008040970800500003017000602009010030000906001584200804301,128346975357198246469257138641975823592483617783612459814539762936721584275864391,0.08071429998381063,44,3203,3159
316000470402080030500300002130000000007000000894500007620930004700002053903408601,316259478472186539589347162135724896267891345894563217621935784748612953953478621,0.36467430001357570,46,17430,17384
100230908008060030300815006410370500805090060960020104020003095000001607700650410,146237958258469731397815246412376589875194362963528174621743895534981627789652413,0.02987029997166246,42,624,582
246350790007090380308100005460070809002009040900000007610000070705004012829706003,246358791157692384398147265461275839572839146983461527614523978735984612829716453,0.07027319999178872,42,2541,2499
290400300000560090308279000010080900625004080809000005460000070502001006980706401,296418357147563298358279614714385962625194783839627145461832579572941836983756421,0.16235300002153963,45,7248,7203
200300409008029050409508026310600008600050032700000001070000004803040005540712003,257361489168429357439578126312694578684157932795283641971835264823946715546712893,0.07061840000096709,45,2597,2552
100450709068097030509803064730000090000080010800000002010530608000064001206918503,123456789468197235579823164731245896652389417894671352917532648385764921246918573,0.04020689998287708,43,1068,1025
200308609060149080300007005430080700001402030900713002020030000009025006853601904,214358679567149283398267145432586791671492538985713462126934857749825316853671924,0.03396199998678640,42,737,695
230600509006080230009005186090800000000090063700000001010000908025010074947568302,238671549156489237479235186391846725582197463764352891613724958825913674947568312,0.14526429999386892,44,6244,6200
270140908016090040409000006000905802007000060600703004060500400002000081703809625,275146938316298547489357216134965872527481369698723154861572493952634781743819625,0.11113859998295084,45,4530,4485
240371500100040070309000001400780906003000000500106002821000700064000015705604208,246371589158249673379568421412785936683492157597136842821953764964827315735614298,0.06703969999216497,45,2336,2291
160205009270060580009000006300400008000090700790003002820000947030000065607904203,168245379273169584549378126312457698485692731796813452821536947934721865657984213,0.16733550000935793,46,7384,7338
340170600070090020209300007500780903094060000803005204420000800038000051651009702,345172689176498325289356147512784963794263518863915274427531896938627451651849732,0.02018870000028983,43,97,54
130260500250070000409508073310607804070020000800005002920000600003000025685002107,137264589258379461469518273312697854574821396896435712921753648743186925685942137,0.10315629997057840,44,4262,4218
240130509050060020109007040502800601000010782800002004000000805730000016905001073,247138569358469127169257348572894631493516782816372954621743895734985216985621473,0.14167589996941388,45,6010,5965
237500109008760040409000005300250008690084030500007006710020900000071023020003701,237548169158769342469312875371256498692184537584937216713625984945871623826493751,0.05413790000602603,44,1646,1602
106370900200190300309206050510600703800050010900004005420030500008000071700001832,146375928257198346389246157514682793872953614963714285421837569638529471795461832,0.15786989999469370,44,6708,6664
150200406439080000008000000300008009006097241790461005000840600200005018805003904,157239486439186572628754193341528769586397241792461835913842657264975318875613924,0.02357839996693656,44,266,222
200450809000260700000008105310500007000090000704003006920700608640900070805612093,237451869158269734469378125312546987586197342794823516921734658643985271875612493,0.02428439998766407,45,311,266
154260700060040805000007040400006008000080300986003012610800207030020081042001053,154268739367149825298357146423516978571982364986473512615834297739625481842791653,0.12887439999030903,44,5541,5497
130400208400300100000001037300004509080090060604005002910700005020006800806053971,137469258458372196269581437371624589582197364694835712913748625725916843846253971,0.10869490000186488,45,4335,4290
400900368360140907000000045100003006650000470007006032500600000002031650906704213,415927368368145927279368145124573896653289471897416532531692784742831659986754213,0.06693319999612868,43,2468,2425
240301009150090304000050070601000008480000050093002017906800005734520000805719043,247361589158297364369458172671945238482173956593682417916834725734526891825719643,0.02710489998571575,42,417,375
205607309160035200000000060400000008090180007003094012500709803820040500936052041,245617389168935274379428165451276938692183457783594612514769823827341596936852741,0.03294389997608960,42,682,640
200156809100409000060030051300907005574200600000805037700580900000604003006070582,237156849158429376469738251381967425574213698692845137713582964825694713946371582,0.05293880001408979,43,1754,1711
325008179160200400009000030800005004530690820006004051600970000048010060903046012,325468179167239485489157236871325694534691827296784351612973548748512963953846712,0.03300939995096996,42,672,630
400728003130009276000000085310000009082000500007064012500000900743900008806540700,465728193138459276279136485314275869682391547957864312521687934743912658896543721,0.03769200004171580,45,920,875
102308009350070140790004050400000807560080090907000001200900706030010020609005014,142358679356279148798164253421596837563781492987432561215943786834617925679825314,0.02920150000136346,45,569,524
306209801120400500000050030203000005074090308905360004701908006060000903009035012,356279841127483569498156237213847695674591328985362174731928456562714983849635712,0.04434989998117089,43,1091,1048
107589042200400109000030050070001006000090200602070013800900407020040090006013025,137589642258467139469132758374251986581396274692874513813925467725648391946713825,0.03898569999728352,46,815,769
402761309300209407000340260200030078800900001507000032000000004040015706005002093,452761389368259417179348265214536978836927541597184632721693854943815726685472193,0.34209970000665635,44,15205,15161
107459082200100409009080030500028064380500207602300010003700006720090003006000020,137459682258163479469287135571928364384516297692374518813742956725691843946835721,0.14102169999387115,44,5981,5937
465000092100200300080060075300507009000890204008000037590400703720900800006050041,465378192179245368283169475342517689657893214918624537591486723724931856836752941,0.02381420001620427,45,225,180
106047093307109200400060500010002009620010475009086021800704006070000130065000042,156247893387159264492368517513472689628913475749586321831724956274695138965831742,0.02101270004641265,42,68,26
137048069200600013009070084305002007000506000800000050601804005750000000004065321,137248569248659713569173284315482697472596138896317452621834975753921846984765321,0.02737629995681345,45,357,312
105234089308100000470060000200456078600000000090300015500603007730000001006010042,165234789328197456479568123213456978657981234894372615541623897732849561986715342,0.23691540001891553,46,10432,10386
027050069408100003060040108203005007070800904000020030601002005740500300085030710,127358469458169273369247158213495687576813924894726531631972845742581396985634712,0.02329350000945851,45,217,172
316009028209100407000050300501007084090004706060090000000005009640900800087043150,316479528259138467478256391521367984893524716764891235132785649645912873987643152,0.03110909997485578,45,613,568
108004070300500008070010200206409007040001906007060410600003025000650300835042060,158234679362597148479816253216489537543721986987365412694173825721658394835942761,0.11891339998692274,45,4870,4825
154000986268100007079080250401309075000600803630010000700002009800000700020040030,154237986268195347379486251481329675592674813637518492743852169815963724926741538,0.05425300000933930,45,1630,1585
206074050300000006480020070620908540105063200090052630000005082040000700568090310,216374859357189426489526173623918547175463298894752631731645982942831765568297314,0.04875189997255802,43,1363,1320
107068092208000107430070500002004059500002006000030000000803975900500600740026810,157368492268459137439271568312684759574192386896735241621843975983517624745926813,0.04242579999845475,45,1010,965
058000697400002005000000102024005069380007501090020030700003906940500200065010073,258134697471962385639758142124385769386497521597621834712843956943576218865219473,0.03944089997094125,45,1026,981
205000019100009007300040500003002076590407003021063000000004758900700620057021934,245376819168259347379148562483592176596417283721863495612934758934785621857621934,0.05459170002723113,43,1752,1709
041050760500069003009400500006090070200000005050000300003806954920730100865041230,341258769572169843689473521136592478297384615458617392713826954924735186865941237,0.03427490004105493,44,667,623
158030090409107003273400000000070080500902001690000500005001039800600700946050810,158236497469187253273495168312574986584962371697318524725841639831629745946753812,0.04441699996823445,45,1003,958
056010040170009006000400102002080097760105008900000600001006074600900205849050361,256318749174529836398467152412683597763195428985274613521836974637941285849752361,0.04128399997716770,44,1101,1057
105360090200009005080200006003090080701408003090010500007004038900500407634070259,145367892276189345389245176453692781761458923892713564517924638928536417634871259,0.02781130000948906,44,392,348
045061080108009005370200000012040090700603002800010600001006073900100804586030920,245361789168479235379258416612547398794683152853912647421896573937125864586734921,0.02786040003411472,44,470,426
207040060008309057400600002000060080500803001890010600001004735900700800085036190,237145968168329457459678312312467589576893241894512673621984735943751826785236194,0.29096820001723245,45,13339,13294
038040070509007008100500306012050090400901002090080405001002083700800000846030251,238146579569327148174598326312654897485971632697283415951462783723815964846739251,0.03039620001800358,44,546,502
058340070209008045400200006010890050507000038980500102002005091600700000740080600,158346279269178345473259816316892457527614938984537162832465791691723584745981623,0.04371850000461563,45,1145,1100
138057060002008003000304100001080090200906004090040802003005046900600007850070231,138257469462198753579364128341782695285916374697543812713825946924631587856479231,0.06570400000782683,45,2134,2089
126048750308009006409500300040080090500007063000000200007004035900700002865030401,126348759358279146479516328642183597591427863783695214217864935934751682865932471,0.04272379999747500,45,1136,1091
157240098368107005400300007013080000500001004890000000001060089940000501680400703,157246398368197245429358617213784956576921834894635172731562489942873561685419723,0.03868509997846559,44,897,853
207060039050003046300408000070032900600004075490000208014020007905007003706500492,247165839158293746369478521571832964682914375493756218814329657925647183736581492,0.05222810001578182,43,1489,1446
137040589208130060400507003000070600000001008790000000003052004904703806870960301,137246589258139467469587213381475692542691738796328145613852974924713856875964321,0.08449600002495572,43,3121,3078
137050480200030060500407001400070800006008014900620705003040072702903008800000103,137256489248139567569487321425371896376598214981624735613845972752913648894762153,0.09118750004563481,44,3390,3346
247056080100009060300187400000060800005008003890700500001073048603402001900005206,247356189158249367369187425732561894415928673896734512521673948683492751974815236,0.03442310000536963,44,731,687
457310620000005040100247000070080500000001076090000802002034005905102084800709200,457318629328695147169247358271486593583921476694573812712834965935162784846759231,0.09032039996236563,45,3530,3485
240061870100009042300200600050670020700004006000000714517026083608400007900708200,245361879176859342389247651451673928792184536863592714517926483628435197934718265,0.03963710000971332,43,1032,989
215040780400007320309200005080020000002501008000800602001082003926004001807900200,215349786468157329379268145183426597692571438754893612541682973926734851837915264,0.02218590001575649,45,191,146
130428560200069030400307008010000000700001005090600204001000053502904601900510740,137428569258169437469357128314295876726841395895673214641782953572934681983516742,0.02838729997165501,44,513,469
138050970260008030400200006040060000002091003000300001010007004927005008604810720,138456972269178435475239186341562897582791643796384251813927564927645318654813729,0.06575669994344935,46,2396,2350
130480250200090040460205008010000005500021063000308104000009032903014006640702801,137486259258193647469275318312647985584921763796358124871569432923814576645732891,0.05261800001608208,42,1668,1626
130250680208000040400600007320040800001096004600002703070010900003005472940807500,137254689268179345459638127325741896781396254694582713572413968813965472946827531,0.05451770004583523,44,1811,1767
210300500000000040400170006720091604065000719100706803030080400008002075600504901,216348597357269148489175236723891654865423719194756823531987462948612375672534981,0.05970999994315207,44,2107,2063
217060300400039000300002005020007500004010732790306014531600900042800003800203000,217568349458139267369742185123487596684915732795326814531674928942851673876293451,0.05257359996903688,44,1739,1695
150200708008000000309508002410300870007000023600402001060000004924005037830746009,156234798248197365379568142412359876597681423683472951761923584924815637835746219,0.26521719997981563,44,12488,12444
230140605108060000400207003014870000602003018900600302020030009806001007790405260,237148695158369724469257183314872956672593418985614372521736849846921537793485261,0.02553699997952208,42,433,391
200560390108370020300004001070090004402000057600400012810020065025000003730805009,247561398158379426369284571571692834492138657683457912814923765925746183736815249,0.04876510001486167,44,1537,1493
320001580100069040400500006540000800003000465690805031710030954064000008800104002,326471589158269743479583126541326897283917465697845231712638954964752318835194672,0.11403590004192665,43,4830,4787
140270380000054000300006045480007009001060834600940012010020008026000003807405001,145279386268354197379816245482137569791562834653948712514623978926781453837495621,0.50191829999675974,44,24530,24486
306109400200400090400085600060300900503017000704008001820500700037042019905700860,356179428278463195419285673162354987583917246794628351821596734637842519945731862,0.11882319999858737,43,5191,5148
120954000008073050500206004390000000004010035600307902710030690806000003950860041,127954386468173259539286174391528467274619835685347912712435698846791523953862741,0.03006250003818423,43,590,547
357400108160200900200008350410300069000000080800004003620040700004051030705906804,357469128168235947249178356412387569573692481896514273621843795984751632735926814,0.03409119998104870,44,803,759
250100093310000400400008002020600500794020010500001004630080709042003001905400208,257164893318297465469358172123649587794825316586731924631582749842973651975416238,0.08647720003500581,45,3451,3406
156300209020050060308006054500080003080010046000005701030020890842000035900000012,156348279427159368398276154514687923783912546269435781631524897842791635975863412,0.08999210002366453,45,3650,3605
100250039250009070300007054510003402070010680000405007020508703034000008700030921,147256839258349176369187254516873492473912685892465317621598743934721568785634921,0.04565980000188574,43,1339,1296
200357009600000208049000000400010000080426001100803004700600902024030070965742813,218357469657194238349268157472519386583426791196873524731685942824931675965742813,0.02071259997319430,43,79,36
200389406069020018408007020100008004590070000004001003020040900005016240906702801,217389456369425718458167329172538694593674182684291573721843965835916247946752831,0.14997339999536052,43,6679,6636
100438509208009000009000800400512000580090000002004003800007200005041030906025714,167438529248159367359276841473512986581693472692784153814367295725941638936825714,0.44414139998843893,46,21078,21032
100268059200300000400071030300002905590080760804009001700400603023000040905830207,137268459258394176469571832316742985592183764874659321781425693623917548945836217,0.08476040000095963,43,3392,3349
530107409064000080200400030300005906420090050805004003000930805002076010003501692,538127469164359287279468531317285946426793158895614723641932875952876314783541692,0.10472230002051219,43,4337,4294
106208000040190000309060018400706809580000670007005001810400900024070085705000342,156238794248197536379564218431726859582941673697385421813452967924673185765819342,0.03776080004172400,43,933,890
140207008058060000300000060500302609490070010703001025600080200905010080837605941,146237598258169734379458162581342679492576813763891425614983257925714386837625941,0.05934360000537708,42,2068,2026
304628009100009800009000600500306000010290706006004035400003508035080017708500362,354628179167459823289137654542376981813295746976814235421763598635982417798541362,0.06996039999648929,43,2584,2541
205407098060230400079080021302004000690000140004001006520700800043060019006000273,235417698168239457479586321312674985697358142854921736521793864743862519986145273,0.03803930000867695,43,982,939
205109007100307504000080310300002000680900705004000061506203478900070050007001923,235149687168327594479586312351762849682914735794835261516293478923478156847651923,0.03068590001203120,43,523,480
247503019108200006060070002400002008580000030003007021900600007725090063006000045,247563819158249376369178452471352698582916734693487521914635287725894163836721945,0.24813549994723871,45,11216,11171
207409068100360709060080000305000006720630890806000032940800007002000900003005014,237419568158362749469587321315298476724631895896754132941823657572146983683975214,0.06856440001865849,45,2474,2429
759104002100300609000050000203407006460000000007003428600705004900020760075046013,759164832142378659386259147213487596468592371597613428621735984934821765875946213,0.23696080001536757,44,10387,10343
456203001107400203020090000201009007980070400004000039600700045709050020045020076,456283791197465283328197564261349857983576412574812639612738945739654128845921376,0.02558600000338629,44,345,301
207050089140200305080090002000004008470980200000007061500600007720000900968000514,237451689149268375685793142356124798471986253892537461513649827724815936968372514,0.11114270001417026,46,4344,4298
247006085100409600000070020000007008680010400003005210800903701500260009034081060,247136985158429673369578124412697358685312497793845216826953741571264839934781562,0.02589839999563992,45,281,236
217406009400109700000070000005607008180000203004003010600802307850700004073060182,217456839438129765569378421325617948186945273794283516641892357852731694973564182,0.10701169999083504,44,4271,4227
237000085158200900009050000500006002380020060000005014700900406920010300846003290,237149685158267943469358127571496832384721569692835714713982456925614378846573291,0.05949519999558106,45,1823,1778
148209065207300409000040010501603004420050900703000150800905007630000500000010023,148279365257361489369548712581693274426157938793824156812935647634782591975416823,0.02676979999523610,44,405,361
105068047700401002240057610017039086002004105000000004000805073850900401000010020,195268347736491852248357619417539286362784195589126734621845973853972461974613528,0.05194780003512278,43,1710,1667
327100089100209006000070020200007004000904302004000761901005048870400905045090010,327146589158239476469578123213657894786914352594382761931725648872461935645893217,0.18289869994623587,44,7854,7810
207010089100509003050020140002065008000008302080070005001806907760900820000032651,237614589146589273958327146312465798475198362689273415521846937763951824894732651,0.02204779995372519,43,218,175
403058096100309008080060130004036085390502407060000001600905002940600700000023019,473158296126349578589267134214736985398512467765894321631975842942681753857423619,0.02793089998885989,42,379,337
201009687300100009000060010103046098480200300007000004900604005850720900000035042,241359687368172459579468213123546798485297361697813524932684175854721936716935842,0.05166370002552867,45,1519,1474
317006089500109604060070000104002008200300400090080021001823005950600800003050216,317246589528139674469578132134762958285391467796485321641823795952617843873954216,0.07084500003838912,43,2674,2631
346109078100200009098060000603700004700500860085003002000802096530000400800070021,346159278157284639298367145613728954724591863985643712471832596532916487869475321,0.02983299997868016,45,470,425
302400719100203008080150002007000006634700090005010000001024003920000800700039520,352468719176293458489157632217945386634782195895316247561824973923571864748639521,0.08612849999917671,46,2684,2638
345210709000009000270040063400620097006000200790004000800950006007400832604083001,345216789168379524279548163481625397536197248792834615813952476957461832624783951,0.14320589997805655,44,5694,5650
125348607300000000090200050200010809004000300850003001500890002002500906903026008,125348697376159284498267153237415869614982375859673421561894732782531946943726518,0.93653629999607801,46,44033,43987
145367209000009000070050063700590046002000900690014002500920007006700504807035001,145367289368249175279158463781592346452673918693814752514926837936781524827435691,0.15163959999335930,43,6311,6268
305400789260089000400050061106000890890070506570008000630000004700000052052006300,315462789267189435489357261126534897893271546574698123631825974748913652952746318,0.20200230000773445,45,9215,9170
315248609000070000089000020100020803003004000890013002500460087008700206602085001,315248679426179538789356124154627893263894715897513462531462987948731256672985341,1.38039020000724122,44,64016,63972
356248709200000000080000050400020078028000100790013004500690041001500207802031005,356248719274159386189367452413926578628475193795813624537692841961584237842731965,0.19729320000624284,44,8032,7988
017460392208130067069000800120080006700090000050301008601040009090003005870016004,517468392248139567369257841123784956784695123956321478631542789492873615875916234,0.15044840000336990,43,6394,6351
100540092050000030209000405600093000000007008500810064021900603803005009965021807,136548792458279136279136485682493571314657928597812364721984653843765219965321847,0.14173460000893101,44,5952,5908
307190064010000070209000105100000000000007002804630009030700406740009001986041327,357198264418256973269473185175924638693817542824635719531782496742369851986541327,0.45360999996773899,45,20855,20810
200430089060000040409000301100370000000004002800060007010003900940718006785692413,251437689368129745479856321126375894537984162894261537612543978943718256785692413,0.08083819999592379,44,2879,2835
200430089060000040409000301100370000000004002800060007010003900940718006785692413,251437689368129745479856321126375894537984162894261537612543978943718256785692413,0.12520090001635253,44,4728,4684
200460078076000050409000002100090000000001004500030607060003800810026005945718236,251469378376182459489375162124697583637851924598234617762543891813926745945718236,0.34692759998142719,45,15859,15814
300760082068200050209000006500070000000805003700090001010006200920037005837521964,354769182168243759279158346541372698692815473783694521415986237926437815837521964,0.08866199996555224,44,3218,3174
008007369000000208025009700210073805400590031090800400000008006750640003860035027,148257369379164258625389714216473895487592631593816472931728546752641983864935127,0.02484110003570095,43,326,283
008000914100000703073009600340072005500930076090500200000003007926010008730046029,258367914169428753473159682341672895582931476697584231814293567926715348735846129,0.08529289998114109,44,3062,3018
008300014000400703073009000340070005500901076007500200004003500920010008730846029,258367914169428753473159682341672895582931476697584231814293567926715348735846129,0.05957569996826351,45,2017,1972
100260089058000460300000005500000006000703012002010503020007600430028007976541238,147265389258379461369184725513492876684753912792816543821937654435628197976541238,0.04085920000215992,43,958,915
007008569001000208089006300350087006100690035090500700000004003920860007640735021,237148569461359278589276314352487196174692835896513742715924683923861457648735921,0.03746319998754188,42,899,857
400360027069000840500000009300007000080006035000020781030004900840091002957832614,418369527269175843573248169321587496784916235695423781132654978846791352957832614,0.15500379999866709,43,6471,6428
100006047009500328273009100310092004507040003000300090000008405740050000980174032,158236947469517328273489156316792584597841263824365791631928475742653819985174632,0.03259399998933077,43,605,562
201000078306100450489005100100097083000800024000000610700003800810026005940718036,251469378376182459489375162124697583637851924598234617762543891813926745945718236,0.06115189997944981,42,1878,1836
200000658008100490460000700500001004600450037000830520003005100840013009170289045,217394658358167492469528713532971864681452937794836521923745186845613279176289345,0.02740550000453368,43,481,438
100000925008409360360000100400008006500690013000700850004003600920067001730142089,147386925258419367369275148471538296582694713693721854814953672925867431736142589,0.02711040002759546,43,177,134
300000816008400390560000700200008007400320058000700120000005200730014009950872031,347259816128467395569183742213598467476321958895746123681935274732614589954872631,0.07842530001653358,45,2876,2831
300000816008400390560000700200008007400320058000700120000005200730014009950872031,347259816128467395569183742213598467476321958895746123681935274732614589954872631,0.06798140000319108,45,2330,2285
100320096000100080009000105503004900420073001000210438002006800050002000964031207,145328796276159384389467125513684972428973561697215438732546819851792643964831257,0.46706850000191480,45,21954,21909
300490078000300090009000106203004500680059003000830614001005900040006000965013802,356491278128367495479528136213674589684159723597832614831245967742986351965713842,0.07494340004632249,45,2691,2646
400230069000100040000000201105002400290056003300490825001004900040005000856023704,418237569529168347673549281185372496294856173367491825731684952942715638856923714,0.05437929998151958,45,1776,1731
150248069008160457409000200070005000500010006000800035002000800935001000840720091,157248369328169457469357218271635984583914726694872135712596843935481672846723591,0.12173009995603934,45,5052,5007
300490078100300090009000136203004500680059003000830614001005900040006000965013802,356491278128367495479528136213674589684159723597832614831245967742986351965713842,0.02833110000938177,43,490,447
150936048002100597409000300010004000700080002000310076001400700973005600840760023,157936248362148597489257361216574839734689152598312476621493785973825614845761923,0.04302580002695322,43,1008,965
230458096108000047409000000070206000600090001000370082003700800725003400840900023,237458196158639247469127538371286954682594371594371682913742865725863419846915723,0.05642859998624772,45,1668,1623
340125089007000026209400000060003000800010003000580071005700900928001300730800612,346125789157398426289467135561273894872914563493586271615732948928641357734859612,0.03742420003982261,45,824,779
250163079009050021401200000020006000700090006000510032003700600947001250682900317,258163479369457821471289563124376985735892146896514732513728694947631258682945317,0.05775249999715015,42,1934,1892
150349076009000035203000000012007000500090003000280041001900600735001400946800312,158349276469712835273568194312457968584196723697283541821934657735621489946875312,0.08737740002106875,44,3385,3341
450136098100000047200800000001002000580060004000780021005600900923000400846300750,457136298138295647269847135371452869582961374694783521715624983923578416846319752,0.12068989995168522,46,5006,4960
360140059400000078000200310106002800280091003700860042001900407040000000857004900,368147259412359678579286314136472895284591763795863142621935487943718526857624931,0.18839629995636642,45,7881,7836
230458091100000048409300020061004900570031004800000032008000470023009800945000203,236458791157692348489317526361284957572931684894765132618523479723149865945876213,0.04724579997127876,43,1180,1137
340510892100039007000400030001005900580064003700120046004700089007000601835001200,346517892158239467279486135461375928582964713793128546614752389927843651835691274,0.02587740001035854,43,269,226
130467298200089001000100060001006800372091400900500030000700005000000613059003700,135467298267389541498125367541236879372891456986574132613742985724958613859613724,0.18705860001500696,46,7979,7933
260458379300069008400200050006004700530086000700500020000800004007940502024005800,261458379375169248489237156196324785532786491748591623653872914817943562924615837,0.36189679999370128,45,16207,16162
210347089300089006400250030001602700670094000980500020000900005005010900039005400,216347589357189246498256137541632798672894351983571624164923875725418963839765412,0.06220490002306178,45,2261,2216
210368094400029006300450020002805400580046000600700080000670003006000207045003600,217368594458129736369457821172835469583946172694712385821674953936581247745293618,0.43020110001089051,45,19545,19500
350641089160079005400380060004803500590017000700902010000500008007020406045006200,352641789168279345479385162214863597596417823783952614621534978937128456845796231,0.02373160002753139,43,282,239
140238096200096007300450082002803900580042000600501020000600009005000608036009450,147238596258196347369457182472863915581942763693571824714685239925314678836729451,0.10359379998408258,43,4197,4154
546038297100740056000500480203007800480001000690000504000000945002800670760095100,546138297128749356379526481213457869485961732697283514831672945952814673764395128,0.03654120001010597,42,805,763
154078269200150084000400750403005800670001000890000002500040970006800520730092100,154378269267159384389426751413265897672981435895734612521643978946817523738592146,0.02972530003171414,42,508,466
154078269200150084000400750403005800670001000890000002500040970006800520730092100,154378269267159384389426751413265897672981435895734612521643978946817523738592146,0.02341689995955676,42,253,211
451037608600150043000400070507000400160002500290000006700020060005800730840013900,451237698679158243382469175537681429164392587298574316713925864925846731846713952,0.05676919996039942,45,1555,1510
241036709300190054000270063405000600120003000790000005600080040053700820870029000,241536789367198254589274163435817692126953478798462315612385947953741826874629531,0.06152859999565408,44,2064,2020
345017609100380045000400017401000800760008000900050002500830060024900530839046000,345217689176389245298465317451723896762198453983654172517832964624971538839546721,0.02484860003460199,43,267,224
137086209200190047000500038306000905720009000800070004500930080002700510670015400,137486259258193647469527138316248975724359861895671324541932786982764513673815492,0.02415110002039000,43,204,161
261048509300169028000200031102000700690007000700010003500890067006700850830026000,261348579375169428489275631142953786693487215758612943524891367916734852837526194,0.16887310001766309,43,7485,7442
256137849300040002400200530005003400600018000000400750001700026002000380060052000,256137849397845612418269537125973468674518293983426751531784926742691385869352174,0.79382090002764016,46,37054,37008
256137849300040002400200530000003400600018003000400750501780026002000380860052070,256137849397845612418269537125973468674518293983426751531784926742691385869352174,0.10187630000291392,42,4127,4085
256137849300040002400200530000003400600018003000400750501780026002000380860052070,256137849397845612418269537125973468674518293983426751531784926742691385869352174,0.05758769996464252,42,1939,1897
256137849300040002400200530000003400600018003000400750501780026002000380860052070,256137849397845612418269537125973468674518293983426751531784926742691385869352174,0.12213970004813746,42,4901,4859
260370058400100030509000107120507006380600004600810003002700860043000000756081002,261379458478125639539468127124537986387692514695814273912743865843256791756981342,0.04671159997815266,43,1475,1432
400350829200100050560008100100005008000800002786020001600000937052000080870064005,417356829238149756569278143124695378395817462786423591641582937952731684873964215,0.38092440000036731,46,17607,17561
200340067300100090400008105500704008000800006807020304000900540643001000985032001,251349867368157492479268135536714928124893756897625314712986543643571289985432671,0.16303290001815185,45,7287,7242
201340769300200004409100350120007006600090021000600830702080005030001070840025010,251348769367259184489176352128537496673894521594612837712983645935461278846725913,0.07019110000692308,43,2496,2453
100320098208100050300000102400603000000200001702080003010800970927016005834759016,145327698268194357379568142481673529693245781752981463516832974927416835834759216,0.19267140002921224,42,8765,8723
000100095107200360280000701500398006000600003803010007010800500720060004938754012,346187295157249368289536741571398426492675183863412957614823579725961834938754612,0.10284519998822361,43,3842,3799
200130589100200360360008000400020005000900072090070403600750948020001050780060031,247136589158297364369548127471823695536914872892675413613752948924381756785469231,0.09187119995476678,44,3091,3047
100240067403000900270000004300580006006400031704013008020800540830054000045700183,158249367463178925279365814312587496586492731794613258627831549831954672945726183,0.03322670003399253,43,772,729
200410089108300700460008021300100004000200015805090007020700690780061002046800173,237416589158329746469578321372185964694237815815694237521743698783961452946852173,0.03749519999837503,42,949,907
100360289300000100260008000400000006002900730093080002910450328820031070030800041,147365289358249167269178453471523896582916734693784512916457328824631975735892641,0.08964100002776831,44,3434,3390
100450792207100300480007000300040009000900031094010006920870653540091080060300014,136458792257169348489237165312546879675982431894713526921874653543691287768325914,0.03656619996763766,42,769,727
001500980270000506605100070420015009000200065039000700810034007900670048760852003,341567982278349516695128374426715839187293465539486721812934657953671248764852193,0.03326460003154352,42,576,534
100040079207003600400067003000600097062000300970081004000730986040005000080900451,136248579257193648498567123314652897862479315975381264521734986649815732783926451,0.03950910002458841,46,1008,962
100040079207003600400067003000600097062000300970081004000730986040005000080900451,136248579257193648498567123314652897862479315975381264521734986649815732783926451,0.06965040002251044,46,2261,2215
100040079207003600400067003000600097062000300970081004000730986040005000080900451,136248579257193648498567123314652897862479315975381264521734986649815732783926451,0.04591939999954775,46,1001,955
056309280470052009009400057310007000000000708907040000620900005003800692895006403,156379284478152369239468157312587946564291738987643521621934875743815692895726413,0.02611870004329830,43,415,372
250068094401000508300057021004500769036004000980010002000800947040901000070600153,257168394461329578398457621124583769736294815985716432612835947543971286879642153,0.02800580003531650,42,496,454
250068049308000205400002080002005608583001000690080003001900804035004000040800071,257168349368479215419532786172345698583691427694287153721956834835714962946823571,0.04151189996628091,45,862,817
057108390460029008008400021120003700030094005005010002610800040000000206879002103,257168394461329578398457621124583769736294815985716432612835947543971286879642153,0.02431019995128736,43,216,173
157308290260059007009200058370004900080002005502070001810900070000000503745006109,157368294268459317439217658371584962684192735592673841813925476926741583745836129,0.03768440004205331,42,891,849
208370950150008070003500028310005800080092003004080002820900000007006009946007201,268371954159428376473569128312645897785192643694783512821934765537216489946857231,0.27289070002734661,44,12223,12179
205196387100008059009400610431005800650000004008010003510700060024000705870009001,245196387167328459389457612431275896652983174798614523513742968924861735876539241,0.02728779998142272,42,478,436
268371954100008076003000120310005800780090003004000002820000060037000409946007001,268371954159428376473569128312645897785192643694783512821934765537216489946857231,0.05259680002927780,43,1457,1414
250067089108000275309008000000003008603080004840600010001000697036004802080726031,254167389168349275379258146512473968693581724847692513421835697736914852985726431,0.10482569999294356,42,4024,3982
247358691100009073009000400430005000800690004006800020610000780024001906985006002,247358691158469273369127458431275869872693514596814327613942785724581936985736142,0.03838189999805763,42,706,664
108300429360000007000020136203700900680109200000800014520047600900000000047600090,158376429362491857479528136213754968684139275795862314521947683936285741847613592,0.04306499997619539,46,1124,1078
207400681148000000500000043305600100480300000000800074710008402900720006026500910,237459681148236795569187243375694128481372569692815374713968452954721836826543917,0.05813630000920966,45,1876,1831
106509284250004000400000071301000400570400000000600032610005807700000049049700360,136579284257184693498326571361297458572438916984651732613945827725863149849712365,0.06425769999623299,46,2151,2105
