Puzzle,Solution,Execution Time,Zeros,Guesses,Backtracks
207408609100090007000070000370602098600000001580719063800524006005060800906837102,237458619158296347469173285371642598694385721582719463813524976725961834946837152,0.03334239998366684,41,521,480
257000439300000006160000082400603005003912800090040010601537908000821000085090320,257168439348259176169374582412683795573912864896745213621537948934821657785496321,0.02445690002059564,42,227,185
000374089008100400470086003030000048507640391090000052820067005003900200000231074,216374589358129467479586123132795648587642391694813752821467935743958216965231874,0.03635660000145435,42,540,498
208369407600154003500278006004000800305080702780010045400000008052000630060843020,218369457679154283543278196124537869395486712786912345431625978852791634967843521,0.16003009997075424,41,5250,5209
468051739100000600000670012084030060315406007097080040000910074900000300753064291,468251739172349658539678412284137965315496827697582143826913574941725386753864291,0.04050920001463965,39,699,660
146000598207000304389000127400060002600872001002010900000643000060589040930020085,146237598257198364389456127413965872695872431872314956528643719761589243934721685,0.04964849998941645,41,1114,1073
147903268000000000309070105410060089603000401095080630000534000500692003030010020,147953268258146397369278145412365789683729451795481632821534976574692813936817524,0.25839709996944293,43,8947,8904
040096580000007009300208174010000948800000007934000060481605003600700000073140020,147396582258417639369258174716532948825964317934871265481625793692783451573149826,0.07403499999782071,45,1990,1945
307165209200394006000278000012000860803000402490080035600000008784000523030020040,347165289258394716169278354512439867873651492496782135621543978784916523935827641,0.08223670005099848,42,2448,2406
100238005200040006400679008002090600508020901690000052700000004835402179046010520,167238495289145736453679218312594687578326941694781352721953864835462179946817523,0.11841320001985878,41,3107,3066
100458002200109003009237100000684000600395008890010064021000730940000021760020085,136458972257169843489237156312684597674395218895712364521846739948573621763921485,0.03608980000717565,41,432,391
340080019100040002009107300000623000603794105790010036401000603935000278870000041,347286519158349762269157384514623897683794125792815436421978653935461278876532941,0.04891349998069927,40,1098,1058
125030489300109007000000000201070804700491006090080070512000748907000602860725013,125637489348159267679248135251376894783491526496582371512963748937814652864725913,0.02644489996600896,40,251,211
037140560108006004460570008010000290904007685080000430590730006601009003073650910,237148569158296374469573128316485297924317685785962431592731846641829753873654912,0.02308090002043173,39,212,173
030000208248100076069270003610380000000000000000092014900043860350007921806000030,137456298248139576569278143612384759493715682785692314921543867354867921876921435,0.17841589997988194,45,5792,5747
130200450000300008809070013460105000003080100000704032320040906600003000085009041,136298457247351698859476213462135879573982164918764532321547986694813725785629341,0.13992320001125336,46,4551,4505
107246500000010400000078020302400956080000070794005208020890000003050000005762801,137246589258319467469578123312487956586921374794635218621893745873154692945762831,0.05446590000065044,45,1121,1076
250160800160000702009008040400600908020080030905003001040700600702000014006014027,254167893168349752379258146413625978627981435985473261541732689732896514896514327,0.28013720002491027,46,9435,9389
147306002250100000300200145410508607005062800820703504500800769670900000984605001,147356982258149376369287145413598627795462813826713594531824769672931458984675231,0.11342010000953451,37,3389,3352
200347096360000000009802000410500907080090010703006048000903800000000079940685001,258347196364159782179862435412538967586794213793216548621973854835421679947685321,0.06269990000873804,46,1625,1579
347009028150000600200100435410685003005093800890417006700900584530000900986004012,347569128158342679269178435412685793675293841893417256721936584534821967986754312,0.02102089999243617,37,81,44
057208406400150070300060001210504000004000100000306049800020004040071003502603910,157238496468159372329467851213594687694782135785316249831925764946871523572643918,0.18323749996488914,45,6175,6130
006357928000000704300084005412500097083970050597800013700098006000000209004723581,146357928258619734379284165412536897683971452597842613725198346831465279964723581,0.03010709997033700,38,422,384
103207408460090037070030010300504009084912370090080040901653704800000001006000900,153267498468195237279438516312574869684912375597386142921653784835749621746821953,0.04939250001916662,42,912,870
206000308350000061190060027400503009002896100003070200600732004700010005839040712,246157398357289461198364527461523879572896143983471256615732984724918635839645712,0.04194019996793941,41,875,834
100098254408000000059400607300845000080000030000132008801009460000000705975360001,137698254468527319259413687312845976584976132796132548821759463643281795975364821,0.05001280002761632,45,1066,1021
207459601000000000069128470000296000050814020890070064600000008720080016980030042,237459681148367259569128473471296835356814927892573164613742598724985316985631742,0.11670740001136437,42,3674,3632
107254089392160400000070200200000070500802134900000020000030800635980700809627013,167254389392168457458379261213546978576892134984713625721435896635981742849627513,0.10070020001148805,41,2690,2649
100368009400259008080010050012080490504000802690724031900506003000000000046832910,157368249463259178289417356312685497574193862698724531921546783835971624746832915,0.02552210004068911,41,291,250
000629540200084600400005102070000039602000407380000050703800005005910004046253000,137629548259184673468375192571462839692538417384791256713846925825917364946253781,0.06351730000460520,45,1523,1478
007269030000540700350108006520000047674900385890000012410605009000890200005724060,147269538268543791359178426521386947674912385893457612412635879736891254985724163,0.02054409997072071,40,109,69
026154780108000304479080251200060008500709003090020040000070000000948000015030490,326154789158297364479386251231465978584719623697823145942571836763948512815632497,0.10185390000697225,44,3077,3033
246010097150200006309407105000040000470895061000020000501906803760300009938050072,246518397157239486389467125612743958473895261895621734521976843764382519938154672,0.02750780002679676,40,336,296
046030097002109008700000100060095073400802009590360010004000005900501300830040720,146238597352179468789654132261495873473812659598367214614723985927581346835946721,0.02599750005174428,45,243,198
002140860408250000170300004010000076605702341090000028520900007806570000007820630,352147869468259713179368254213485976685792341794613528521936487836574192947821635,0.06082729995250702,42,1529,1487
006280700207351009800400031010000096503008147070000023300700068704832005005140300,136289754247351689859467231412573896593628147678914523321795468764832915985146372,0.02340609999373555,41,41,0
007348900300169007400050003070030080503000704690000021920504038706801405045090170,217348956358169247469257813172436589583912764694785321921574638736821495845693172,0.03525740001350641,40,533,493
150347620000068005000200040412070060675009203983010070000800030000034006830926750,159347628247168395368295147412573869675489213983612574796851432521734986834926751,0.03462260001106188,41,529,488
017259640000060000500748003030080060805906702290000034000315000150090076004627300,317259648428163597569748123731482965845936712296571834672315489153894276984627351,0.06947449996368960,42,1942,1900
004167290000340500100008034080003006702000401900700080610500009003081000095674100,354167298268349517179258634581423976732896451946715382617532849423981765895674123,0.03174410003703088,45,412,367
100234007040000030308000401421060398580020064009000200002040500030516070960872043,196234857247158639358697421421765398583921764679483215712349586834516972965872143,0.04973770002834499,41,1106,1065
207108309300629007060307050012000690500080001800090004021030780734805926980000013,247158369358629147169347852412573698593486271876291534621934785734815926985762413,0.02167350001400337,39,107,68
100058963000009057039600200370400008482036095690700001013500800000003019800014372,147258963268349157539671284371495628482136795695782431913527846724863519856914372,0.04866730002686381,40,920,880
230050097070060050581409236100000005860295041700804003000080000007521800900746002,236158497479362158581479236124637985863295741795814623612983574347521869958746312,0.05140390002634376,41,1191,1150
200300489450000070009400005600200104092060830803001002900005700030000058586007001,217356489458129673369478215675283194192564837843791562921835746734612958586947321,0.35827069997321814,46,12723,12677
300498002008153400009000310120800006485070031790300005001000980002739100900681003,317498652268153479549267318123845796485976231796312845631524987852739164974681523,0.02512810000916943,41,194,153
257010469160020075400060008300206007082090640000154000000030000043070250670000013,257318469168429375439567128314286597582793641796154832921635784843971256675842913,0.11778359999880195,44,3498,3454
200040005060159040450000013100000004580090062600512008001923500030671020006485700,217348695368159247459267813172836954583794162694512378741923586835671429926485731,0.09121529996627942,42,2627,2585
100357009050249070070000040501000706680070054400615008003060800014732960000891000,146357289358249671279186543531428796682973154497615328923564817814732965765891432,0.03577979997498915,42,700,658
300248679000050830080000200104500007738490026506700003010000700000010460800627391,351248679267159834489376215124563987738491526596782143612934758973815462845627391,0.02812659996561706,42,344,302
107246509050793060009050200302000906510389042700000001021000390000030000970625018,137246589258793164469158273382417956516389742794562831621874395845931627973625418,0.03812520002247766,41,382,341
206458709500030008080167020103000806060000010700306002601985204000040000870623051,216458739547239168389167425123574896465892317798316542631985274952741683874623951,0.01986739999847487,41,54,13
246100380100300007009060005530704000004080700000506013400030900900001004085002631,246157389158349267379268145532714896614983752897526413421635978963871524785492631,0.23770359996706247,46,8162,8116
160237089000149000009050300200306007690070021754010963002000600030504070800961005,165237489328149756479658312281396547693475821754812963512783694936524178847961235,0.04061040002852678,41,793,752
047103560100000009360070021510704096403865102000010000600357004000080000075902610,247193568158426739369578421512734896493865172786219345621357984934681257875942613,0.03227669995976612,42,431,389
086203479200100308300070052402500006063780900708400003600040097800900605075801234,186253479257194368349678152412539786563782941798416523621345897834927615975861234,0.02979489997960627,38,155,117
204571089000340200570068400300050006485600071700080004820036700000810900903725068,234571689168349257579268413312457896485692371796183524821936745657814932943725168,0.02271749998908490,39,141,102
307189500000035740000000810580000976090000050673000024014000000026850000005764201,347189562168235749259476813581342976492617358673598124714923685926851437835764291,0.15902409999398515,45,5031,4986
108000307560000081070080040300407008006592700005010400801935604900040005054020130,148256397569374281273189546312467958486592713795813462821935674937641825654728139,0.18346460000611842,43,6063,6020
106045789200007304400390001002780000584609000009530000700820005800006403903051872,136245789298167354457398621312784596584619237679532148741823965825976413963451872,0.03095489996485412,40,352,312
051400367308000004470500000137080050000604000090050872000002045700000601946005720,251498367368127594479536218137289456582674139694351872813762945725943681946815723,0.10159570001997054,45,2945,2900
240050019108209304509104602000040000480965031000010000003507400900030007756090123,247356819168279354539184672371842965482965731695713248813527496924631587756498123,0.04468920000363141,41,1069,1028
038000760170306089690000035200080001307592608009010200000935000900761004760020013,538149762172356489694278135256487391317592648849613257421935876983761524765824913,0.05410110001685098,41,1257,1216
100040009370000054409000701210050076500781002000462000040975030001020900700814005,165247389378196254429538761214359876536781492987462513642975138851623947793814625,0.04067249997751787,44,915,871
307251608000009042209000310410000006573096001890000007601000870000008059905742103,347251698158369742269487315412573986573896421896124537621935874734618259985742163,0.03647260001162067,41,707,666
107302508008090100300581004010639080070000030893000621620050047700010002005274800,147362598258497163369581274412639785576128439893745621621853947784916352935274816,0.09975739999208599,41,2671,2630
320648019008030400409050208210000084580000093704803102030000020600080005070926040,327648519158239467469157238213795684586412793794863152931574826642381975875926341,0.05976840003859252,42,1322,1280
200375004090080050408000103530000087620897031700503002045000620800942005900651008,216375894397184256458269173531426987624897531789513462145738629863942715972651348,0.03036530001554638,40,218,178
300297105000036070079000320512300004783040012694700008027000890000024050900873201,346297185258136479179458326512389764783645912694712538427561893831924657965873241,0.12392209999961779,39,3928,3889
402509103075238460000070000050080090713090845809000307520040086900020004600701002,482569173175238469396174258254387691713692845869415327521943786937826514648751932,0.02346759999636561,41,186,145
190000057248070169300169004002513800000496000000782000700050008034000670905807402,196248357248375169357169284472513896583496721619782543721654938834921675965837412,0.03257759998086840,41,373,332
140000078360040091200000006401539607002060900000712000500623009026000430937804162,145396278368247591279185346481539627752468913693712854514623789826971435937854162,0.02441909996559843,40,211,171
200138400040059100000007035500000689080090070963000004610800000004670010005912006,256138497347259168198467235571324689482596371963781524619843752824675913735912846,0.42767760000424460,46,15281,15235
140200806050160403009080002400308000003070900000502008900020500601053040805004067,147239856258167493369485712412398675583671924796542138934726581671853249825914367,0.10688150004716590,46,3064,3018
201400708300000652600250041006308009030592800008706004800970023700000985903800107,251463798374189652689257341126348579437592816598716234865971423712634985943825167,0.07902730000205338,40,2174,2134
417208659508109307000050000100624008000010000005803200700000006840090075956781432,417238659528169347369457821173624598284915763695873214731542986842396175956781432,0.06345420004799962,40,1637,1597
150200009268009007079000125500700000610000094000003006431000970900800463700004012,154237689268159347379468125592746831613582794847913256431625978925871463786394512,0.29028479999396950,45,10164,10119
347158209000009008000060450100000095280000031590000002068030000700600000902874316,347158269625349178819267453173482695284596731596713842468931527731625984952874316,0.21762800001306459,45,7450,7405
007036590200197400360050000401800059680900731503600042830010000700369200006084310,147236598258197463369458127471823659682945731593671842834512976715369284926784315,0.02805249998345971,39,76,37
401279305200145009070060020105000908380000041700010003000050000043927510007681400,461279385238145679579368124125734968386592741794816253612453897843927516957681432,0.04257440002402291,42,723,681
103248506400109003020060080731000965860000047900070001300000008007836400058914730,173248596486159273529367184731482965862591347945673821394725618217836459658914732,0.04271710000466555,40,941,901
038469510100000002570030068300000009002301700007285400700853004040716020856000173,238469517169578342574132968315647289482391756697285431721853694943716825856924173,0.02438080002320930,40,254,214
050070289407200006238000000002065040600809003080120500000000832700001604849030010,156374289497218356238956471312765948675849123984123567561497832723581694849632715,0.07169369998155162,45,1842,1797
147230096250100003009000802000080740700624138000090260004000607830500004976840051,147238596258169473369457812612385749795624138483791265524913687831576924976842351,0.02061090001370758,40,98,58
050046079468000003300100000004710060100482007080069200000004005900000482840920010,251346879468297153379158624524713968196482537783569241612834795935671482847925316,0.05630060000112280,46,1474,1428
036010790100000006200346001002060900600105007790020064000000000940601025863752419,436518792158279346279346581312467958684195237795823164521984673947631825863752419,0.07747399999061599,42,2021,1979
016350000408109000300400108180000693503206417760000825600700304905801000047630000,216358749478169532359427168182574693593286417764913825621795384935841276847632951,0.03222440002718940,40,415,375
340010067100368009000407000071030690400659001000070000004080900825000713930020084,349215867157368249268497135571834692482659371693172458714583926825946713936721584,0.11740920000011101,44,3505,3461
350040079169000003072300005001430000000712000000098400500004780800000394940060052,358146279169257843472389615281435967694712538735698421513924786826571394947863152,0.04658249998465180,46,1066,1020
100207689000008305009405100721300006893600004654900003007506900000003507500709431,145237689276198345389465172721354896893671254654982713437516928912843567568729431,0.04496410000137985,40,687,647
150600239208009057070054008000430000002175384000890000010023006905008043830900725,154687239268319457379254618581436972692175384743892561417523896925768143836941725,0.02769269997952506,40,282,242
137400809048000005500000014310024900006301582980065400600000098053000006894600203,137456829248139675569278314315824967476391582982765431621543798753982146894617253,0.06712620001053438,41,1622,1581
105279604008030500760845021000050000406000702500408003620080035850000017903502806,135279684248136579769845321312657498486391752597428163621784935854963217973512846,0.03461269999388605,40,626,586
400507109000290054500030076010002900206000705008400020950040002620051000804309001,432567189167298354589134276315672948246983715798415623951746832623851497874329561,0.03449890000047162,45,260,215
102305709005080100000167000040050070517020394800000001920030017730816052600702008,162345789475289163389167245243951876517628394896473521928534617734816952651792438,0.03099260001908988,41,282,241
150273089070060010629000357012000970500000006700194002001946700000712000200308001,154273689378569214629481357412635978593827146786194532831946725945712863267358491,0.07691330002853647,42,2007,1965
100205608000069037369000500403520000582090046601780000914000300000013064800902105,147235698258169437369478521473526819582391746691784253914657382725813964836942175,0.06420790002448484,41,1537,1496
104257806007080050509006000310500008470028319690700002701005000006040030903871605,134257896267189453589436271312594768475628319698713542721365984856942137943871625,0.03013959998497739,40,482,442
200356009058020360309000205400000003576030428890000056001000500700815002900642001,247356819158429367369187245412568973576931428893274156621793584734815692985642731,0.25023419997887686,42,8573,8531
130245000200080030908006210400607009860390027700804003304002980500070040690418000,136245798247189536958736214413627859865391427729854163374562981581973642692418375,0.06329310004366562,41,1786,1745
147300529000009006360200107000090800570812604000040200620900708000001002834600951,147368529258179436369254187412596873573812694986743215621935748795481362834627951,0.04701599996769801,42,1016,974
341206598200105007570040026003080700700409001800010004132060875000000000904837602,341276598268195437579348126413682759726459381895713264132964875687521943954837612,0.02631119999568909,40,286,246
408030107000479000070080040014658730050000060900020004000542000742000356090763020,468235197123479685579186243214658739357914862986327514631542978742891356895763421,0.07127740001305938,44,1713,1669
205040609060050040079080150124060978000000000800010004030694020542000796080725030,215347689368159247479286153124563978693478512857912364731694825542831796986725431,0.02179610001621768,42,114,72
100230097260009040080460021500070804000000000708090003420013080030700019970046005,154238697267159348389467521592371864613584972748692153425913786836725419971846235,0.03882620000513270,45,730,685
407030809560070034039060750300020008000000000600847001010684090943000286050392010,427135869568279134139468752371526948284913675695847321712684593943751286856392417,0.18314989999635145,42,6252,6210
240167305300420070090380000000000807837200956000000103010830000600910080980756201,248167395351429678796385412125693847837241956469578123512834769673912584984756231,0.06002099998295307,42,1394,1352
200469008140005090000080240000040809486000523705030000021090000050700061600351002,237469158148275396569183247312546879486917523795832614821694735953728461674351982,0.03487759997369722,45,533,488
350000079060050040409070105210587096500603002800104003000040000731962584900030001,352418679167259348489376125213587496574693812896124753625841937731962584948735261,0.02626750001218170,41,162,121
340200708007108034509430102130004905400300200790002603203940806004506079950700401,341265798627198534589437162132674985468359217795812643273941856814526379956783421,0.02354280004510656,36,211,175
400000578000000009309080014104702095200403001790805302610050403900000000857000006,461239578528174639379586214134762895285493761796815342612957483943628157857341926,0.11706389999017119,45,3486,3441
310209048050167030000080000123040987600000002905000403700020004542000396896030721,317259648458167239269483175123645987674398512985712463731926854542871396896534721,0.02850509999552742,40,117,77
230000018050030090400070005360000049000000000584601327719843562603705904040962070,236459718157238496498176235361527849972384651584691327719843562623715984845962173,0.02905170002486557,39,396,357
350109076060070040400030009010763080000000000597000463821050634905426807700080002,358149276169275348472638159214763985683594721597812463821957634935426817746381592,0.02330559998517856,41,173,132
050001089000389406400076120210400008000000000800003074021930007608712000940800010,356241789172389456489576123213457698794628531865193274521934867638712945947865312,0.10023129999171942,45,3061,3016
310209048050167030000080000100040007000308000985702463701926804002000300806030701,317259648458167239269483175123645987674398512985712463731926854542871396896534721,0.02610489999642596,42,230,188
200500837050307004309080050581000003000106000700000192010020309900803010837001005,246519837158367924379284651581972463492136578763458192614725389925843716837691245,0.24138720001792535,45,7593,7548
358000179160357082000090000280030096000702000637010524800523007000000000705189203,358246179169357482472891635281435796594762318637918524816523947923674851745189263,0.04248699999880046,41,780,739
057190048100000007480005000301002760500030002092700103000200075900000004730049620,257196348163428597489375216341852769576931482892764153614283975925617834738549621,0.13434019999112934,46,4157,4111
030000050208169307079030180010706090500010002607000403901070508700805001060321070,136487259258169347479532186312746895584913762697258413921674538743895621865321974,0.07752699998673052,42,2074,2032
360209080100456903400003560013504000704390006096807000800001640600748302940605010,365279481178456923429183567213564879784392156596817234837921645651748392942635718,0.04172269999980927,38,878,840
040200019200091600160480000501600090400070003090005201000032086005760004830004020,347256819258391647169487352571623498482179563693845271714532986925768134836914725,0.10473810002440587,46,3020,2974
005207093130400006279060000312500000500000007000004325000040569900001082750809400,465217893138495276279368154312576948584932617697184325821743569943651782756829431,0.14279230003012344,45,4722,4677
207301080050629004369004000410000006600000001900000037000400798700218060030905402,247351689158629374369784125412837956673592841985146237521463798794218563836975412,0.23554819996934384,45,7478,7433
000317069160092003009000000410700008503904607700008032000000300900830046630549000,254317869168492573379685124412763958583924617796158432841276395925831746637549281,0.28950439998880029,45,10305,10260
200037080350269000000080006612300005403000702700002643900020000000941028020750001,246137589358269174179485236612374895483596712795812643931628457567941328824753961,0.08329859998775646,45,2407,2362
200137009050269070109080206610000095400000002790802043031020450000941000820050061,246137589358269174179485236612374895483596712795812643931628457567941328824753961,0.03986520000034943,41,730,689
145397268000125000209060501403602905500000006607000302050040020900010003830050014,145397268368125497279468531413672985582934176697581342751843629924716853836259714,0.08952909999061376,41,2626,2585
145397268300125007009060500410000085500000006007000300750040029900716003006050700,145397268368125497279468531413672985582934176697581342751843629924716853836259714,0.02840259997174144,43,360,317
340250000100469000009080005461000907502000306703000284900040600000831009000076042,346257891158469723279183465461328957582794316793615284917542638624831579835976142,0.09339990001171827,45,2695,2650
200570409350429000000036005103000500504000803009000102600740000000951067905083004,216578439357429681498136725123894576564217893789365142631742958842951367975683214,0.33442530001047999,45,12178,12133
150038090402197038300050100000304009508071204000502003800010900601729085970043020,157238496462197538389456172216384759538971264794562813823615947641729385975843621,0.04916469997260720,39,1117,1078
040368970160409003389100406002093008600080004008014009521900807970801005030745190,245368971167459283389172456412593768693287514758614329521936847974821635836745192,0.07841090002330020,36,2224,2188
028346570059000620674000831005060700400090002000010000000825000590030087063974210,128346579359187624674259831215463798436798152987512346741825963592631487863974215,0.04367440001806244,42,662,620
045687230360102054200000001000030000450020017000741000020374080930000075087915340,145687239368192754279453861712536498453829617896741523521374986934268175687915342,0.05460109998239204,41,1401,1360
047328000250100074300400000010004908780591632090006107900800000430600089076945000,147328596258169374369457821612734958784591632593286147921873465435612789876945213,0.03861350001534447,41,747,706
147239050250000000300504100421000087570900403893000015600703500730000000985621030,147239856258167349369584172421356987576918423893472615612743598734895261985621734,0.02442069997778162,40,157,117
350217096100349007400000001000605000580000074090824010010702050920000068837956142,358217496162349587479568321241675839586193274793824615614782953925431768837956142,0.02399970003170893,39,188,149
050149060000572000400060009132090475600050002590000036900624008700000003046735290,258149367369572184471368529132896475687453912594217836913624758725981643846735291,0.03278830001363531,42,548,506
457163800100000000000087030301500068002010400940008207010870000000000001006341572,457163829138295746269487135371524968682719453945638217513872694724956381896341572,0.85163170000305399,46,31271,31225
310560007067009203000000000170400005680215074900006028000000000809600450700024081,314562897567189243298347516172498635683215974945736128421853769839671452756924381,0.52346729999408126,46,19348,19302
250147039000259000000000000124070985500000002709000301000435000970020064845090123,256147839387259416491368257124673985538914672769582341612435798973821564845796123,0.04103399999439716,43,888,845
305040708060183090480060032040326080706891503000000000000738000000000000054612370,315249768267183495489567132541326987726891543938475216192738654673954821854612379,0.09008600004017353,44,2491,2447
358109002000030009270060030010000078002654300590000040020040057600080000900506813,358179462164235789279468135416392578782654391593817246821943657635781924947526813,0.03095919999759644,46,484,438
250367091000208000380050072000483000040709020708506103420000087900841006806902405,254367891167298354389154672512483769643719528798526143421635987975841236836972415,0.06531709997216240,39,1737,1698
200167009460352078170080026302548607000000000004010800000734000035020760040090030,258167349469352178173489526312548697586973412794216853621734985935821764847695231,1.11341409996384755,43,41306,41263
200040009360129057070080020502691704000000000706030802000050000047813260053060940,215347689368129457479586123582691734134278596796435812621954378947813265853762941,0.38922279997495934,43,13344,13301
302567108180293065560010072205836709000070000700040006000354000003080200050000010,342567198187293465569418372215836749436975821798142536621354987973681254854729613,0.03029570000944659,43,286,243
217300609400060007060000010000030894583904261000020573020000040900010002846700105,217348659458169327369257418172635894583974261694821573721583946935416782846792135,0.36123819998465478,43,12508,12465
351247689000030000279000314020706090500090008800010006010973040900050007780020031,351247689468139752279568314124786593536492178897315426612973845943851267785624931,0.06039110000710934,42,1408,1366
127300589000000002960008017040030050071205846080060070610004098000000005895600724,127346589458179632963528417246837951371295846589461273612754398734982165895613724,0.06578080001054332,42,1701,1659
010540682060007000400008000520300794800090005694005023000600008000800030786023040,317549682268137459459268317521386794873492165694715823132654978945871236786923541,0.31278600002406165,46,10788,10742
310248079240109086508306102420080057000090000060010020050704090004901700030060010,316248579247159386598376142421683957873592461965417823152734698684921735739865214,0.04357869998784736,42,956,914
140020690008100007000400015420581069081940002790236041000600074004700006970010520,147325698258169437369478215423581769681947352795236841812653974534792186976814523,0.06141689996002242,40,1574,1534
260308097470000026509070401120507069085090270796080135800000002900010008050020010,261348597478159326539276481124537869385691274796482135813965742942713658657824913,0.05190210003638640,40,1188,1148
360100240000000005540260079000395080836710502000628010420830057000000004780500360,367159248192487635548263179214395786836714592975628413421836957653971824789542361,0.03435480000916868,42,621,579
140258093300000007000407000400613008603974105000000000570040069000090000936825714,147258693358169247269437581425613978683974125791582436572341869814796352936825714,0.03201710002031177,43,512,469
160258790005000008000060045500601289917080506600503471000020067002000004830714950,164258793375149628289367145543671289917482536628593471491825367752936814836714952,0.05241449997993186,39,1211,1172
040316090100000003000279000300050009400000006090603050730040065002861700684537912,248316597179485623563279148316754289425198376897623451731942865952861734684537912,0.02435769996372983,43,241,198
200148360061000008080530007000607095926050801000801036090460002035000004700985610,257148369361279548489536127813627495926354871574891236198463752635712984742985613,0.03285089996643364,41,528,487
510037060602000009080090215100502000006080100000604003421060050900000301070940082,519237468642158739783496215134572896256389174897614523421863957968725341375941682,0.13145950000034645,46,4172,4126
100200500200009300380070162460900000502304906000006047624050093005600008008002001,146238579257169384389475162461927835572384916893516247624851793715693428938742651,0.13276880001649261,45,4401,4356
007040800400000001060108070312875649704060502000304000620030084043602150870010026,137246895458793261269158473312875649784961532596324718621537984943682157875419326,0.02965089998906478,40,301,261
460315892008000103030200457000503008304160500000807001010600985003000206850921734,467315892528479163139286457271593648384162579695847321712634985943758216856921734,0.03484019997995347,38,446,408
137420000208000007560000240000004038785263401000001072420000850903000006876190000,137426985248359167569718243612974538785263491394581672421637859953842716876195324,0.04362680000485852,43,956,913
105070902240189056680000017000508000070090040093060120021943860300000004060857030,135476982247189356689325417412538679876291543593764128721943865358612794964857231,0.02461090002907440,41,244,203
000654000108000403069000250310806079506392804080000020620080045790000081805961702,237654198158279463469138257312846579576392814984517326621783945793425681845961732,0.02299159998074174,39,176,137
000456000208109306069020750041000890500080003896000125600040008980000032703895604,137456289258179346469328751341562897572981463896734125615243978984617532723895614,0.01951140002347529,40,63,23
351248700200000000489060000100004390600902007098500002000030974000000006003796251,351248769276159483489367125125674398634982517798513642562831974917425836843796251,0.05185560003155842,45,1220,1175
246381050000000086098050400000723590000000000083465000004070930720000000030516274,246381759157249386398657412461723598572198643983465127614872935725934861839516274,0.04624280001735315,45,1077,1032
037568140100000005049020760002080500400296003080305070690040057700000004804937601,237568149168479235549123768312784596475296813986315472691842357723651984854937621,0.03949260001536459,41,831,790
006308700307109402400070006031080920004000500060504070200756009640801037070423050,126348795357169482498275316531687924784912563962534178213756849645891237879423651,0.03540090000024065,41,702,661
007004098058300001400100003010090037384000926790080040600005004800002510940800300,137524698258369471469178253512496837384751926796283145621935784873642519945817362,0.03371210000477731,45,609,564
100308005307169402400070006001000900784010563960504078000706000600891007870020051,126348795357169482498275316531687924784912563962534178213756849645891237879423651,0.03345340001396835,40,613,573
004201079100479003200000005040003008602040301700100020400000006900814007830506400,364251879158479263279368145541623798682947351793185624415732986926814537837596412,0.10829420003574342,46,3406,3360
300408005107269304098050120003000800589020413740000062600584007900601008070030040,326418795157269384498357126263145879589726413741893562612584937934671258875932641,0.03883209999185055,40,731,691
100309002209157403400060005004000800607090501980203047500000008740901056890030014,158349762269157483473862195314576829627498531985213647531624978742981356896735214,0.08784729999024421,41,2172,2131
300108009400239006200060003102000608643080915870000024500000007730801062960020031,356178249487239156219465783192354678643782915875916324521643897734891562968527431,0.14618059998610988,41,4904,4863
006005089307200000400067502200600908003408200904002006809520003000001405740900800,126345789357289164498167532271653948563498217984712356819524673632871495745936821,0.10728300001937896,45,3225,3180
008267050209300000000050108400503086590000034680704002704030000000001603030875200,148267359259318467367459128471523986592186734683794512714632895825941673936875241,0.06715200003236532,45,1873,1828
008235700300000002000000000210050098580000074700408001621040957935020486840596013,168235749359174862472689135214357698586912374793468521621843957935721486847596213,0.05233129998669028,40,1239,1199
047368520300000006060000030400937002700681004800205007002000800901402703674010295,147368529358129476269574138415937682723681954896245317532796841981452763674813295,0.06834669999079779,41,1475,1434
137460080200079060060000107300500006570000039900004001801000090040950008090042613,137465982258179364469283157312597846574618239986324571821736495643951728795842613,0.90069070004392415,45,32593,32548
501260070300000080009300024430002008100896003200400051710003400050000007060051902,541268379327149586689375124436512798175896243298437651712983465953624817864751932,0.04555360000813380,46,1073,1027
017050820200000007000000000100639008340785092790402036671020984030060010900871003,417356829269148357583297641125639478346785192798412536671523984832964715954871263,0.07011079997755587,41,1963,1922
157200380408300005000000207200005090503904702090800004601000000900003601075009423,157246389428397165369158247214735896583964712796821534631472958942583671875619423,0.06209770002169535,45,1745,1700
017463590300000004060000010620709053500010002000602000030000080945286731876931425,217463598358197264469825317621749853594318672783652149132574986945286731876931425,0.02411140000913292,39,244,205
158237400302009058070000000000004807534098026000002504020000000703005041945861200,158237469362149758479586312216354897534798126897612534621473985783925641945861273,0.03750009997747838,42,737,695
005060700601000304840309016100070009700198002980504037203706905008010600560030071,325461798691287354847359216152673849734198562986524137213746985478915623569832471,0.04908319999231026,40,1185,1145
158230060302000050070000002200004007530798026800600004600000080080000601040061273,158237469362149758479586312216354897534798126897612534621473985783925641945861273,1.27896369999507442,46,47331,47285
158070346300050007079000120200080009580792061700603008020105080000040000900827003,158279346362451897479368125216584739583792461794613258627135984831946572945827613,0.02381330000935122,43,225,182
407050306500060007060000080300090008870020014106040703040532070050080030903417602,417258396538169247269374185324791568875623914196845723641532879752986431983417652,0.22117690002778545,43,7493,7450
421300698608049070070000001107026005200570040504093007010000004305084010846700539,421357698658149273973268451137426985289571346564893127712935864395684712846712539,0.05979109997861087,39,1609,1570
317040596060050030000000000105493608630080019790010054070000060040725080800961002,317248596462159837589376421125493678634587219798612354271834965946725183853961742,0.13366639998275787,42,4193,4151
207608301000793000000000000402060809500020004706481503000509000804172905975040132,247658391158793246369214758412365879583927614796481523621539487834172965975846132,0.03588690003380179,41,689,648
150060049000070000200000006301090708004010900905627403800401007706902804549080231,157268349463179582298345176321594768674813925985627413832451697716932854549786231,0.02872750000096858,41,368,327
420136789608000050070000000246000507580690032193000806030000000902000010860915273,425136789618279354379458621246381597587694132193527846731842965952763418864915273,0.04069380002329126,41,670,629
420306089050040020360205047201408605680901072500000003010000050900104008846592731,427316589158749326369285147271438695683951472594627813712863954935174268846592731,0.01886250003008172,37,38,1
150247089000060000009000100502030907003090800804715603200000008708306501065070430,156247389387169254429583176512638947673492815894715623231954768748326591965871432,0.12265829998068511,43,4013,3970
040530691105009000300002000402075809000090000807610205000700003000900506986053020,248537691165849372379162458412375869653298714897614235521786943734921586986453127,0.66581789997871965,46,24178,24132
300246001000397000009000700201060508003070400594010673000504000805609107046080320,357246981168397254429158736271463598683975412594812673712534869835629147946781325,0.03478510002605617,43,553,510
300206001060090050409108706201060508003070400594010673000504000805609107046080320,357246981168397254429158736271463598683975412594812673712534869835629147946781325,0.04695230000652373,40,1013,973
207000109108204000060000284502070403476023098803060701020000945704901000905000807,247386159158294376369517284512879463476123598893465721621738945784951632935642817,0.04069579998031259,40,890,850
010006409408009007069070285104080006830012074906040002041020698602001003090008501,217856439458239167369174285124987356835612974976345812541723698682591743793468521,0.06271959998412058,39,1727,1688
340009100100030769200060004461000508500000001703000246800050003924070005005400027,346789152158234769279165384461927538582346971793518246817652493924873615635491827,0.20017329999245703,45,6612,6567
300000009100050006079030140002080900580792061607504208700963004904070602060401090,356147829148259376279638145412386957583792461697514238721963584934875612865421793,0.04920459998538718,41,1221,1180
201050809400109007500060003128543976000296000600000005372914658010602030006000100,261357849483129567597468213128543976754296381639871425372914658915682734846735192,0.04075759998522699,40,774,734
107352608058060340300070005502080409000090000980704062020030050704020806005000700,147352698258169347369478215512683479476295183983714562621837954794521836835946721,0.45209350000368431,44,16576,16532
207030508150492067300050004002378900400010003890000015021040870704209601000060000,247136598158492367369857124512378946476915283893624715621543879734289651985761432,0.02155820000916719,42,114,72
307050401180006003524090678200000009075912006800000005631040982940001007702060304,367258491189476253524193678213685749475912836896734125631547982948321567752869314,0.02149910002481192,39,126,87
296317458003468200400050003307000905000090000820030047080020090700901006905070302,296317458153468279478259163317684925564792831829135647681523794732941586945876312,0.13207859999965876,42,4414,4372
351040789000179000209080106102090607000050000500000001014502970000817000807060502,351246789468179235279385146182493657793651824546728391614532978925817463837964512,0.27767129999119788,44,9479,9435
107030896200109407060470051410000500500814000890000300020980045600702109905040723,147235896258169437369478251412396578573814962896527314721983645634752189985641723,0.03647920000366867,39,659,620
146050308350009000070010006402000059000921000690000201800030070000100083905070412,146257398358649127279318546412763859583921764697584231861432975724195683935876412,0.23270920000504702,46,8116,8070
348060257100508006670040098000406000000392000500000004701604905950781043804030702,348169257129578436675243198213456879487392561596817324731624985952781643864935712,0.04318479995708913,40,976,936
147060239000349000009070500000090000000218000906507401601953804700080002805020103,147865239258349716369172548512496387473218695986537421621953874734681952895724163,0.22156130004441366,43,7082,7039
300240695060108007074000082120000903485690000790000508031000079040901006900830214,318247695269158437574369182126785943485693721793412568631524879842971356957836214,0.02149020001525059,40,85,45
135060289060009007000000100304500010600832004050001803003000000900700030547020691,135467289268159347479283156384576912691832574752941863813694725926715438547328691,0.14741599996341392,46,4889,4843
457060238000354000360080054020000090500813007700906003600090005940000061875030942,457169238218354679369287154123745896596813427784926513631492785942578361875631942,0.17942459997721016,41,5925,5884
453010782000040009279000106300500408680491000700800501521000604000020005847060923,453619782168247359279358146312576498685491237794832561521983674936724815847165923,0.02398060000268742,40,48,8
107060803300415009000000000015040390704050206890000054900873002680591037070020080,157269843328415679469387125215746398734958216896132754941873562682591437573624981,0.02796019997913390,42,279,237
100205090208169037000000001412300070503810062896500010000000005604752089900601020,147235896258169437369478251412396578573814962896527314721983645634752189985641723,0.06543030001921579,41,1784,1743
351040697470000850000100000100402085000080000590706002000007000024000078765030129,351248697472369851689175243136492785247583916598716432813927564924651378765834129,0.43269809999037534,46,14743,14697
457268139900040008000000000201050807070090020600427001504080703020000080896030512,457268139932145678168379245241653897375891426689427351514982763723516984896734512,0.12125500000547618,42,3599,3557
410060529200000080600290007102000095090080040740000103500036004070000008834020051,417368529259147386683295417162473895395681742748952163521836974976514238834729651,0.43518260004930198,46,15079,15033
007201089158000000269070050012003070600000003080900510020030498000000761870109300,347251689158496237269378154412583976695712843783964512521637498934825761876149325,0.06819820002419874,45,1961,1916
468030019020007068570068004200006903630980000800004605940023006050001092382050071,468235719123497568579168234214576983635982147897314625941723856756841392382659471,0.03309979999903589,39,416,377
100095078408020000279038104001000000340000065000000300507860493000010506860350002,136495278458127639279638154681543927342971865795286341517862493923714586864359712,0.08721199998399243,45,2681,2636
158267349060000070470389015000090000500000003096000450021070530930000086800635002,158267349369451278472389615213594867584716923796823451621978534935142786847635192,0.35782000003382564,42,12969,12927
200019068100000000089470025005067082010000070790240600520093840000000009970850001,257319468164582397389476125435167982612938574798245613521793846843621759976854231,0.17528950003907084,45,5677,5632
418237569060549070570060043000070000830000016796000432280753094000000000900604001,418237569362549178579168243124376985835492716796815432281753694643921857957684321,0.17377789999591187,40,5502,5462
100036089258009000309005012004002008600000001900700200420800907000900846890540003,147236589258179634369485712514692378672358491983714265421863957735921846896547123,0.15334860002622008,45,4980,4935
136458279000030000498060351000302000900000007375000426700684003540000062800925004,136458279257139648498267351614372985982546137375891426721684593549713862863925714,0.06191330001456663,40,1511,1471
210060089050179060460020037020897040600000008890000021001683900030000070900752003,217364589358179264469528137123897645674215398895436721741683952532941876986752413,0.06221699999878183,43,1727,1684
047263580000104000360578014000010000580000027690050048014635890900000006800729001,147263589258194673369578214473812965581946327692357148714635892925481736836729451,0.05951269995421171,41,1390,1349
235010789067398240009020100070040060500000007026000490612070953900000002700932004,235416789167398245489527136371249568594681327826753491612874953943165872758932614,0.10503729997435585,41,3327,3286
007468059050000060200751040000080002580104036600070000010925004020000070940817500,137468259458239167269751348371586492582194736694372815713925684825643971946817523,0.09901669999817386,45,2620,2575
000030000009148200270906041020000070690000084780010032517364829800000006960825013,146237598359148267278956341421683975693572184785419632517364829832791456964825713,0.05611409997800365,40,1180,1140
040237098300040000008900341021680075690002104085410032007300829800090000060825013,146237598359148267278956341421683975693572184785419632517364829832791456964825713,0.03142899996601045,38,452,414
005000769167050000380407215000000058650091430000000026510902684926080000004000592,245138769167259843389467215431726958652891437798345126513972684926584371874613592,0.07953290001023561,41,2061,2020
040010078000270503200008041052030009000492000900080720520900007704021000830040010,345619278168274593279358641452137869687492135913586724521963487794821356836745912,0.10737269994569942,46,3192,3146
230000015108020309569103248000000000000531000690040032703050904020010060056080720,237498615148625379569173248381962457472531896695847132713256984824719563956384721,0.34441299998434260,43,12611,12568
350401079109030508274508163000050000000972000700000002901040605600010004045020730,358461279169237548274598163412356897583972416796184352921743685637815924845629731,0.21086079999804497,43,7275,7232
245000060107250003380407205000020058000891407000040026510902604906580001874000090,245138769167259843389467215431726958652891437798345126513972684926584371874613592,0.04663789999904111,40,1083,1043
030000080250080064490607025000060000000328000680090032501473806800050007069010540,136245789257189364498637125312564978974328651685791432521473896843956217769812543,0.06261959997937083,44,1419,1375
410000089320060074569708132105090408000304000790000065800070006002981700073020850,417235689328169574569748132135697428286354917794812365841573296652981743973426851,0.02808369998820126,40,382,342
136200070400170206070306104500080017000792005600010023010905608900860702865400090,136248579458179236279356184524683917381792465697514823712935648943861752865427391,0.06603240000549704,39,1644,1605
105026009097000016400009235600040000720803561800010000300002958072000043906034002,135426789297358416468179235613245897724893561859617324341762958572981643986534172,0.04890599998179823,42,1088,1046
300607902086000307090350460400030090860501034900080010010870620028000103600104805,345617982186249357297358461451736298862591734973482516514873629728965143639124875,0.03113119996851310,41,477,436
210340905300000204070008010060072009500806001800410050020700090703000008905031027,216347985358169274479258316164572839532896741897413652621784593743925168985631427,0.42936150002060458,45,14748,14703
258140007160000204000009050006000029480503076590000400020700000604000013900061742,258146397169357284743289651316478529482593176597612438821734965674925813935861742,0.13283489999594167,45,4349,4304
205080706007302800080070020000268000870409051090010080013000960908040507700953008,235184796167392845489576123351268479872439651694715382513827964928641537746953218,0.01986030000261962,43,81,38
347156928208000106000070000000743000480912037090000010001000700900827001805461203,347156928258394176169278345512743869486912537793685412621539784934827651875461293,0.07885439996607602,41,2063,2022
251030089000100470000008003012000090034289510060000230100600000078004000940050762,251437689386192475497568123512346897734289516869715234125673948678924351943851762,0.09836740000173450,46,2989,2943
108207604302459108000168000000040000500020007090603010601000809925010763007596200,158237694362459178479168325213745986586921437794683512641372859925814763837596241,0.07284709997475147,41,1995,1954
306040709000108000000070000100090008034856970008010200001904800940507012057621390,316245789479168523582379146165792438234856971798413265621934857943587612857621394,0.02365540002938360,43,219,176
201030609000000000007568100512306897034289510800010004100000008000020000943851762,251437689386192475497568123512346897734289516869715234125673948678924351943851762,0.27748290001181886,41,9613,9572
126050478300200590090000000260070809005104367470090205010000000700900620839010754,126359478347281596598467132261573849985124367473896215612745983754938621839612754,0.04177329997764900,41,861,820
354060798060080030702395104240109056010853020508020301000000000005000600800942003,354261798169487235782395164243179856617853429598624371421536987935718642876942513,0.09253899997565895,41,2754,2713
145070963000090000279050814402000109000931000900080006500000007000615000830729051,145278963368194725279356814482567139657931248913482576521843697794615382836729451,0.20031640003435314,44,6584,6540
237050460100009050069400108300000780000702000085000002401003890050800004076040231,237158469148269357569437128312594786694782513785316942421673895953821674876945231,0.01945889997296035,45,73,28
251030689000090000007060100502040807030289010800010004005673900000000000943851762,251437689386192475497568123512346897734289516869715234125673948678924351943851762,0.04355260002193972,43,732,689
258040796100270000000068102302000004080917253507000001000094305700130000936050417,258341796163279548479568132312685974684917253597423681821794365745136829936852417,0.06705070001771674,40,1648,1608
340010028000472000079000610481000369050030080700080005500297006800503001930861052,345619728168472593279358614481725369652934187793186245514297836826543971937861452,0.02871049998793751,41,264,223
350090401100850030479016005003060007004073612007020004721089003800740020940030108,358297461162854739479316285213465897584973612697128354721689543835741926946532178,0.07415579998632893,39,2045,2006
031465000450100002009000004000306950340070086067502000500000800700003025000759430,231465798458197362679238514182346957345971286967582143513624879794813625826759431,0.16666930000064895,46,5553,5507
057146089100035067062000500001903075500600094008407021014000900900014036036579042,357146289189235467462798513241983675573621894698457321714362958925814736836579142,0.03963739995379001,37,787,750
047196058100203009000000037402307006780900510605804002000000043800701005076435021,347196258158273469269548137412357986783962514695814372521689743834721695976435821,0.06575900001917034,40,1419,1379
000427000400109005089365740000601000100030002068294150902040607000070000857010324,531427896476189235289365741324651978195738462768294153912543687643872519857916324,0.21668100001988932,42,7498,7456
000317000100209005079568120400605007007192400003704200701000809050020040934806512,245317698168249375379568124412635987587192436693784251721453869856921743934876512,0.04443509998964146,39,932,893
047006208100070000009540137402307986700060500605804372001680743800020000076005801,347196258158273469269548137412357986783962514695814372521689743834721695976435821,0.02531439997255802,38,224,186
257060389108203607009070100000000000680000074795000813070902060800705001934816725,257461389148293657369578142412387596683159274795624813571932468826745931934816725,0.05498460005037487,38,1435,1397
047138506000200007060000021010700603030010050806005070520000060600004000904621730,247138596158269347369457821415792683732816954896345172521973468673584219984621735,0.13310340000316501,46,3986,3940
046587310000109000100040006400000008063090140985406732020634050600000004594020863,246587319358169427179243586412375698763892145985416732827634951631958274594721863,0.06196050002472475,40,1691,1651
126478359058000240000020000500000003703952406804000501007000100280701064601040805,126478359358196247479523618562814793713952486894367521947685132285731964631249875,0.05402510002022609,41,1137,1096
056080490208419706409050108000000000090030060680904015010602040700000003965803271,156387492238419756479256138341568927592731864687924315813672549724195683965843271,0.06822360004298389,41,1913,1872
027418590058679240000030000200000007080761030790000054001245800900000005805396401,327418596158679243469532718213954687584761932796823154631245879942187365875396421,0.04986520000966266,41,1084,1043
056034807000109203200078100080400005510390680090800001700085400000603708063041509,156234897478169253239578164382416975514397682697852341721985436945623718863741529,0.02532739995513111,41,258,217
146375802050109603300060000003590007610820040007410006900050000060904701784631905,146375892258149673379268514423596187615827349897413256931752468562984731784631925,0.03942520002601668,38,622,584
140235608000008507500070000210500906490061083670900405800040000000002701750319804,147235698362198547589476132213584976495761283678923415821647359934852761756319824,0.03315339999971911,41,406,365
100679284060100009070400000324000007005030400700000853000004070900001040842795006,153679284468152739279483165324518697685937421791246853516324978937861542842795316,0.80594649998238310,46,29729,29683
208345709059608230470010086302000908580090023000803000020000050905701602640030091,268345719159678234473219586312456978586197423794823165821964357935781642647532891,0.03429659997345880,39,632,593
107245609000369000400000005504826703090457010700903002001000900943000521070192060,137245689258369147469781235514826793392457816786913452621534978943678521875192364,0.05114529997808859,40,1146,1106
107264509000319000400000003001020700682070354700803001010000070520030016870192035,137264589258319647469587123341625798682971354795843261913456872524738916876192435,0.03605439997045323,41,652,611
107305209050196040060070080501234906490010053600000001000000000925040638800529004,147385269258196347369472185581234976492617853673958421714863592925741638836529714,0.03015240002423525,41,216,175
107238000058069001200000080601002508082596037503001604800000050025084006906715000,147238965358469271269157483671342598482596137593871624814623759725984316936715842,0.02707370003918186,40,365,325
136008050050069038400000020300050206892306015700080903500000070020013094974005060,136278459257469138489531627341957286892346715765182943513694872628713594974825361,0.03113340004347265,42,530,488
205139000060084009300500420400000706573016084900000103600700840020041005804623000,245139678167284539398567421412358796573916284986472153631795842729841365854623917,0.03891669999575242,42,699,657
200570903100230060300008502401002009090000030700100805604900008020017006807045001,246571983158239467379468512481352679592786134763194825614923758925817346837645291,0.17829439998604357,45,5692,5647
005206800020389010680050043201000705850000091900000008100734002502060907063925180,315246879427389516689157243231498765854672391976513428198734652542861937763925184,0.03716420003911480,40,778,738
408657100100030060000040705501004008380000047600700503803020000020070001006813902,438657129157239864269148735571364298382591647694782513813925476925476381746813952,0.03451780002797022,45,520,475
002358700030907010679020358305000901180000062200000003720583049000040000804792105,412358796538967214679124358345276981187439562296815473721583649953641827864792135,0.03527150000445545,40,580,540
008104300170098000439007080210000768380700592590000134821005040740086000005403800,658124379172398456439657281214539768386741592597862134821975643743286915965413827,0.02853329997742549,39,337,298
104008609360459200000007005500072004002000500900840002400900000005714083703500401,154238679367459218289167345531672894842391567976845132418923756625714983793586421,0.32558110001264140,45,11460,11415
270348609100569000000002058510400307480200061790800502000004095900785000650921804,275348619148569273369172458512496387483257961796813542821634795934785126657921834,0.02377919998252764,38,176,138
003589407500104300408007052120000906370200001980000205601002094700905600009641703,213589467567124389498367152124758936375296841986413275631872594742935618859641723,0.05603879998670891,39,1371,1332
000385409470096200300007016100600805750903024900500107500002048690031700000459301,261385479475196283389247516132674895758913624946528137513762948694831752827459361,0.02793630002997816,39,392,353
130450600200607013000002507300260805000000000504081002803900000920806004006013098,137458629258697413469132587371269845682345971594781362813924756925876134746513298,0.22374579997267574,45,7772,7727
200050008500109003070284050103745809000901000607823504702090305900010002050402070,241356798568179423379284156123745869485961237697823514712698345934517682856432971,0.13039609999395907,41,4290,4249
006020100100604003200109007410258076000000000705496201501040608900000004074965310,346527189197684523258139467413258976629371845785496231531742698962813754874965312,0.15153799997642636,42,4829,4787
230500400108307006509000018300068005000702000600150003820000604700205109004006032,236581497148397526579624318312468975495732861687159243821973654763245189954816732,0.10860199999297038,45,3497,3452
217450600308002047000000102100037809000000000705940001501000000840600705006025413,217459638358162947469378152124537869693281574785946321531794286842613795976825413,0.30057279998436570,45,10129,10084
150730000200109086309004500400380005060000020900012003001800709790605001000071042,156738294247159386389264517412386975563497128978512463621843759794625831835971642,0.18770179996499792,45,6617,6572
106080207400601008089000360310508096000106000507294803600040009700912004040763020,156389247473621958289457361312578496894136572567294813621845739735912684948763125,0.02164300001459196,40,125,85
208030605300209008070504020403695701000302000507841302700458006800010007060020010,248137695351269478679584123423695781186372549597841362712458936834916257965723814,0.03988850000314415,41,692,651
046030809208106004509400006400761908300904060600853201703500002904607003065010407,146235879278196354539478126452761938381924765697853241713549682924687513865312497,0.02449029998388141,37,216,179
045060802108209007209008506500682903700005060800713205407001609901806004082070301,345167892168259437279348516514682973723495168896713245437521689951836724682974351,0.01933689997531474,36,66,30
079100008500408009604309500100782405200604080400513706701906800900807001065200007,379125648512468379684379512136782495257694183498513726721936854943857261865241937,0.02552159997867420,39,210,171
048030005301009078609080003403605701180302040507801302702050006804006057065020004,248137695351269478679584123423695781186372549597841362712458936834916257965723814,0.06127110001398250,38,1717,1679
108000309260308057003409100312000798000702000700183005800030006600875001057621830,148257369269318457573469182312546798485792613796183245821934576634875921957621834,0.02887979999650270,39,357,318
417058003208400051309007204100000079500302410800000032601005807902600045745023006,417258963268439751359167284123584679576392418894716532631945827982671345745823196,0.02234289998887107,38,147,109
217305094300400026000008005502004001103920457604001003000003009700100042946702018,217365894358497126469218735572834961183926457694571283821643579735189642946752318,0.03601059998618439,40,681,641
054000380268040517070050020510000098607902103800615004000803000900020001030591040,154267389268349517379158426512734698647982153893615274421873965985426731736591842,0.04713850002735853,42,995,953
040008395300040006000030180500000068403617509690000003024060000700080002965700030,146278395358149276279536184512493768483617529697852413824361957731985642965724831,0.13599919999251142,46,3979,3933
256408193100000008308060207400305006507286904003947500001000300700000005980632041,256478193179523468348169257492315876517286934863947512621754389734891625985632741,0.02857939997920766,39,417,378
146008095300200006009005307630020009704953802590080004001006908800700001975004023,146378295357249186289165347638427519714953862592681734421536978863792451975814623,0.03624979994492605,40,715,675
148050792209107308070090040400000007305672904096504280001000400900000001650721039,148356792269147358573298146412839567385672914796514283821963475937485621654721839,0.04891690000658855,39,1079,1040
240019058100060002300208000480002903502196087690004105900605000700080006860043019,246319758158467392379258641481572963532196487697834125913625874724981536865743219,0.03845370002090931,40,748,708
030056008100000706068000104300000040724593681090000005601000870502000009900760010,437156298159248736268379154315682947724593681896417325641925873572831469983764512,0.20644189999438822,46,7122,7076
135270080200000057090008000802007590500601004064800703000700040640000002050012368,135274689286139457497568231812347596573691824964825713321786945648953172759412368,0.12552000000141561,45,4059,4014
137245689408109702060000050700000008680000071095708240003020800820000013076831420,137245689458169732269387154741652398682493571395718246513924867824576913976831425,0.08346449997043237,38,2478,2440
310857024400109006000206000160000089200601007795408613007000800000503000852764391,316857924428139576579246138164375289283691457795428613637912845941583762852764391,0.02268640004331246,39,173,134
130060059700000001000109000315080796420396085086705320500020007072000840803070502,138267459769548231254139678315482796427396185986715324541823967672951843893674512,0.17935129994293675,40,5745,5705
100030008300000005000608000501020709780905046093407510005070400426000857837564921,154239678368741295279658134541326789782915346693487512915872463426193857837564921,0.02387939998880029,39,217,178
290040018100208009000000000709000306500407001080903020601020805850090073974835162,295346718147258639368179254719582346523467981486913527631724895852691473974835162,0.03354989999206737,41,616,575
240050017100609003009104500410060098080503070003801600801030704064702130507010809,246358917158679243379124586415267398682593471793841652821935764964782135537416829,0.02467439998872578,39,212,173
340070291108904005209130087012000809080060000097000302701690048804705006960040173,346578291178924635259136487412357869583269714697481352721693548834715926965842173,0.03215789998648688,37,458,421
340060109051409608600107230010000907470690000080000403700903840034806705860040301,347268159251439678698157234512384967473691582986572413725913846134826795869745321,0.04088009998667985,39,882,843
037150860100206340400300050300580006580719003700460008600800090900601280045920630,237154869158296347469378152314582976586719423792463518621835794973641285845927631,0.07437390001723543,39,2067,2028
150040709027109400408500012002050804980620000004070603201400068035802100840010205,156243789327189456498567312762351894983624571514978623271435968635892147849716235,0.02238629997009411,39,140,101
360050190102093000500000000200309078400782005790405002000000009000970506054030021,367258194142693857589147263215369478436782915798415632671524389823971546954836721,0.68641779996687546,46,25725,25679
250030068604000109183000725300824006000070000000316000031090680040000050867040291,259137468674258139183469725315824976426975813798316542531792684942681357867543291,0.02909359999466687,43,374,331
254060738100307005000200000500402309640893001700605204000700000400901007937080412,254169738168347925379258146581472369642893571793615284815724693426931857937586412,0.08772650000173599,41,2383,2342
016340509407000000398060010180470006520091807760280004631050040802000000075830201,216348579457129683398567412183475926524691837769283154631952748842716395975834261,0.04589280002983287,39,891,852
147050269208106307300070008500000002490785036706000904020000090004507600870030021,147358269258196347369472518531964872492785136786213954623841795914527683875639421,0.09868160000769421,41,2967,2926
047050629008300701100000000510700006480090073900006058000000007705001300834070910,347158629258369741169247835512783496486592173973416258621934587795821364834675912,0.12485850002849475,46,3460,3414
045679230206008900000050007600703004750096102800205006000030009508004700031867420,145679238276348951389152647612783594753496182894215376427531869568924713931867425,0.06824270001379773,41,1967,1926
641278359307149208000050000100000006400090005906502403010000070003904500094020630,641278359357149268289356147125437896438691725976582413512863974763914582894725631,0.27874189999420196,42,9143,9101
254169738100040005300050006000402000042090570700615004810000093000000000937586412,254169738168347925379258146581472369642893571793615284815724693426931857937586412,0.16943469998659566,41,5744,5703
257168349408090702100070008070206090502030406600050003010000050900000007046985230,257168349468593712139472568371246895592831476684759123813627954925314687746985231,0.06137950002448633,41,1676,1635
305678201068000350200153004410000078600487005800912006020000080004806500086020740,345678291168249357279153864412365978693487125857912436521734689734896512986521743,0.03220429999055341,40,577,537
045670091000200007209003000010305008603080105800902030000700609700006000980021740,345678291168249357279153864412365978693487125857912436521734689734896512986521743,0.03094609995605424,46,525,479
206174009308005006400300001160500048583000120790800035800900004907006002601752003,256174389318295476479368251162537948583649127794821635825913764937486512641752893,0.03421030001481995,40,344,304
127356489500029300000400002200607095086090700700203064000800007900014600874965231,127356489548129376369478512213647895486591723795283164651832947932714658874965231,0.03105200000572950,37,49,12
315468927200009405070005000100000050053046209600000070020003000900004501847651392,315468927268179435479235168182397654753846219694512873521983746936724581847651392,0.36290419998113066,41,12736,12695
203468709100529008090000060340000076002090800980000032000030000027040680839756421,253468719176529348498317265341285976762193854985674132614832597527941683839756421,0.06193989998428151,41,1516,1475
200560380508000107300080065182000000453291076697000000700040098905000604800950730,214567389568329147379184265182476953453291876697835412721643598935718624846952731,0.36022739997133613,41,11883,11842
107368204400000003009000100312070859870090012090000060020030040003080600785246931,157368294468129573239457186312674859876593412594812367621935748943781625785246931,0.04256669996539131,41,823,782
204567309008000100079000260182000953050090070090805010000040000005708600846952731,214567389568329147379184265182476953453291876697835412721643598935718624846952731,0.02374499995494261,41,41,0
260073450500000003304500072005300007400090006800007300740002508900000004083950021,268173459579428163314569872125346987437895216896217345741632598952781634683954721,0.65609930001664907,46,24158,24112
107368209008000300203000106301070608740892031000000000002981400600040007014736950,157368249468129375293457186321574698746892531985613724572981463639245817814736952,0.02098040003329515,41,61,20
340915026108000309060000040401060207502080901000107000000050000700891003985634712,347915826158246379269378145431569287572483961896127534613752498724891653985634712,0.02215340000111610,41,166,125
000457000050000070679103425100000008800592004007814300020635040080020030365040291,213457689458269173679183425142376958836592714597814362921635847784921536365748291,0.13955950003582984,41,4420,4379
136040598008000700470508061300080007680000052090402080902371805000020000817050623,136247598258169734479538261324685917681793452795412386962371845543826179817954623,0.07839530002092943,40,1774,1734
200047580500000203340008701120500800407012056690700400810005904900000605700029130,261347589578196243349258761123564897487912356695783412812635974934871625756429138,0.02898890001233667,41,414,373
100250370008070006007100504001400007402090108900006400609005700700040800054037001,146258379598374216237169584361482957472593168985716432619825743723641895854937621,0.24060550000285730,46,7919,7873
207010309108000207340267015400020008580090073000805000000936000905080406030542090,257418369168359247349267815471623958582194673693875124714936582925781436836542791,0.09378179995110258,42,2950,2908
458030190000000508200180036340900705502301049980400301600570083000000604835090210,458736192163249578297185436341928765572361849986457321614572983729813654835694217,0.03933800000231713,39,743,704
250418060100050207300007805470600900502094073690800100700006502900080406830542090,257418369168359247349267815471623958582194673693875124714936582925781436836542791,0.03092280001146719,39,235,196
100239080350000702000500001400908507500070004701605008600002000804000056070416003,147239685358164792269587341436928517582371964791645238613852479824793156975416823,1.03463880001800135,46,39131,39085
240690130100000009070050062400300005583000726700005001620030080900000004054069013,245697138168423579379158462412376895583941726796285341621534987937812654854769213,0.11042889999225736,45,3371,3326
560090038407030205300000006130502089000080000896010523010000050700925001058671340,561297438487136295329458176134562789275389614896714523612843957743925861958671342,0.05066440004156902,41,688,647
205038070010400008090070102100003000573010246000200007601050080800007050050380604,265138479317492568498576132142763895573819246986245317621954783834627951759381624,0.26674640004057437,46,9095,9049
140378092278090631000010000400907005580060074690584023020000050000000000960721048,146378592278495631359216487412937865583162974697584123821643759734859216965721348,0.02292739995755255,41,87,46
140836090000009600060200400500007940480060017096400002001003050004500000030724068,147836295258149673369275481512387946483962517796451832821693754674518329935724168,0.04199840000364929,46,852,806
300251008158497263209030504500306009407000605960000082020000050700915006000762000,346251798158497263279638514512386479487129635963574182621843957734915826895762341,0.04842010000720620,40,1137,1097
054217096208359074070000000600700385500000769700800412010000000806973041037541028,354217896268359174179486253641792385582134769793865412415628937826973541937541628,0.02751619997434318,37,303,266
230479018108000709009080400300208005405090301600315007020804050800906004004751200,236479518148562739579183462317248695485697321692315847721834956853926174964751283,0.03920919995289296,40,651,611
140367098286040753007080100402601809060090070000000000010702080600804007708916405,145367298286149753397285164452671839861493572973528641514732986629854317738916425,0.03906139999162406,40,798,758
320040079158209643409050208201603907560090084890000026010000090000905000005461700,326148579158279643479356218241683957563792184897514326612837495734925861985461732,0.05171939998399466,39,1221,1182
106249008200601093000507000003700009804093265002400007000302000300904051905816002,136249578257681493489537126613725849874193265592468317761352984328974651945816732,0.17730400001164526,42,5852,5810
246537089100409060070000005000305098683090051000608032020000004800901020964752013,246537189158429367379186245412375698683294751795618432521863974837941526964752813,0.02186689997324720,39,131,92
154307089360000010200008653000439000600080395000526000800002534420000070937804062,154367289368295417279148653581439726642781395793526841816972534425613978937854162,0.04120639996835962,40,709,669
137408259050000030060537040040070090700050001590804023600040002000301000875692314,137468259458129637269537148341276895782953461596814723613745982924381576875692314,0.22919049998745322,40,7628,7588
207305619000200403300070250001600090400000006090001700014020007705009000936708504,247385619158296473369174258581647392473952186692831745814523967725469831936718524,0.20660020003560930,45,6940,6895
147306258050000070200080004071030890500010003000875000004050600720000089836749521,147396258358421976269587314471632895582914763693875142914258637725163489836749521,0.04367220000131056,41,829,788
016208390300100006200076040002000059403000207590000400020690004600007002075401680,716248395348159726259376148162734859483915267597862431821693574634587912975421683,0.06239530001766980,45,1647,1602
245109687160000439009000100010004070700081354050003060001000700530000248978302516,245139687167258439389476125613594872792681354854723961421865793536917248978342516,0.05358920001890510,39,1374,1335
147305600250060007009087020000000008406010503500000000070250300800090056005706812,147325689258961437369487125712534968496812573583679241671258394824193756935746812,0.78711879998445511,46,28463,28417
300105009410279056570060024000000000280090041607804205005406900900080002062951470,326145789418279356579368124154632897283597641697814235735426918941783562862951473,0.10823750001145527,40,2566,2526
716208095340050006000006000062034009400000007500860430000600000600080012970401683,716248395348159726259376148162734859483915267597862431821693574634587912975421683,1.20979310001712292,45,44215,44170
460308079170000006000067020006500098308000205740002600020780000900000017850901062,462318579173259486589467123216534798398176245745892631621783954934625817857941362,0.20130670000799000,45,6861,6816
496007813120040069500160000000680000305090187000570000600930000740010026859006431,496257813127348569538169274274681395365492187981573642612934758743815926859726431,0.03939059999538586,41,563,522
147305689250060007360480005010000900006002573080000200670250004820090006935706812,147325689258961437369487125712534968496812573583679241671258394824193756935746812,0.03138319996651262,38,470,432
206107408370040056010080030083902560504361702000804000801000609000608000760493021,256137498378249156419586237183972564594361782627854913831725649942618375765493821,0.02074929996160790,39,94,55
316708942207030506590060017000000000403605108080412060800000005000571000054823690,316758942247139586598264317162387459473695128985412763831946275629571834754823691,0.10083609999855980,40,2921,2881
320509078108070905570080021200305007403761802000408000702030504000000000065942710,326519478148273965579684321281395647493761852657428139712836594934157286865942713,0.04741769999964163,40,1047,1007
140203089000000704360008102400302060582097403600504020810005306000000201720901048,147253689258169734369478152471382965582697413693514827814725396935846271726931548,0.04323710000608116,40,958,918
346207001208000036100008500000405300400010007007603000001500008930000105800701423,346257891258149736179368542612475389483912657597683214721534968934826175865791423,0.09662530000787228,46,2899,2853
140205098008000301360080204400300900780052103500800700620090407004000509930701062,147235698258469371369187254412376985786952143593814726621598437874623519935741862,0.04398269997909665,41,624,583
107309508208010907360000024403257806500090002090604010600783009700000001980102073,147329568258416937369578124413257896576891342892634715621783459734965281985142673,0.02239880000706762,39,77,38
207300086100040039300000005001403900400186007003502400700000003820030004930004501,247359186158647239369218745581473962492186357673592418714965823825731694936824571,0.17424269998446107,46,5787,5741
103548679060100000509000004200400700380751206600800500806000007040300000701684923,123548679468179352579263184215496738384751296697832541836925417942317865751684923,0.10393330000806600,42,3097,3055
043509200700080090280000006000658900010293040006471000400000069070010004008704510,143569287765182493289347156324658971817293645956471328431825769572916834698734512,0.04073130001779646,46,783,737
500200948080140007304000002107408200250391406409705300703000004020610003900800125,571236948682149537394587612137468259258391476469725381713952864825614793946873125,0.02690400002757087,40,327,287
037500942400000030209030001000005190700392005096700000600040509070000004845006210,137568942458129736269437851324685197781392465596714328612843579973251684845976213,0.15109299996402115,46,4741,4695
230410908100009000400700002301007000870142069000500207500004003000900005906025041,237416958158239476469758132321697584875142369694583217512874693743961825986325741,0.08111520000966266,46,2041,1995
058267340060050020270498061000503000080679010507000206800000003900000004746135892,158267349469351728273498561614523987382679415597814236825946173931782654746135892,0.08537889999570325,40,2206,2166
047536280000070000360080057000000000403957602706208503001000900900020001835791426,147536289258179364369482157512364798483957612796218543621843975974625831835791426,0.34996700001647696,41,11779,11738
000100389350090100079008504000780006402615703000230001013002605720060900000900412,246157389358496127179328564531789246482615793697234851913842675724561938865973412,0.03472280001733452,42,650,608
047238560000000000069050120000326000030090040602000803010080070904613205026745390,147238569258169734369457128481326957735891642692574813513982476974613285826745391,0.19894440000643954,42,6724,6682
230184069000609000060375020014090680680050093005000400000060000703010806096040270,237184569158629347469375128314297685682451793975836412521768934743912856896543271,0.49464699998497963,44,17450,17406
230010098000000000068000250006587400402060307709302605000934000600020001094671530,235416798947258163168793254316587429452169387789342615521934876673825941894671532,0.03241509996587411,43,465,422
140030069000000000069457120080020050730090042600000003010982070970613085026040390,147238569258169734369457128481326957735891642692574813513982476974613285826745391,0.07834229996660724,42,2253,2211
140020068000109000069070520012586390870010045500000002000030000904050806085694210,147325968258169734369478521412586397873912645596743182621837459934251876785694213,0.03879200003575534,42,688,646
150467089006000700090050030004576900000030000900000007020613070608040102041982560,153467289286391745497258631314576928872139456965824317529613874638745192741982563,0.29706690000602975,44,10314,10270
247060518000000000060185070402090603080512040000000000000624000804903701936070425,247369518158247396369185274412798653683512947795436182571624839824953761936871425,0.15777990000788122,43,5312,5269
130406298406100000207358040800000300900061850500000600308714060601900000750602431,135476298486129573297358146862547319973261854514893627328714965641935782759682431,0.05218569998396561,40,922,882
136289574000000000490157062204060903305090406000010000001020800800901007960804051,136289574527346198498157362274568913315792486689413725741625839852931647963874251,0.12975979998009279,41,4225,4184
154000308060300009300405020501700903090000080703008201010902007900007010807000592,154269378268371459379485126581726943692143785743598261416952837925837614837614592,0.49323100002948195,45,17808,17763
130200409000190005259407000012000008500809006800000510000905784900081000705002093,137258469468193275259467831312576948574819326896324517621935784943781652785642193,0.04420180001761764,45,915,870
307100605100205079509008000270000006480506792690000003802003000700901058906800107,327194685168235479549678321271389546483516792695427813812753964734961258956842137,0.03957840002840385,42,851,809
306200100200104009109300254401000600680402593502000700704600935800901006903700800,346259187258174369179386254431597628687412593592863741714628935825931476963745812,0.02440569997997954,40,279,239
107500200200304609009008105603000904500603721701000306002006507800901402906400800,147569238258314679369728145623187954584693721791245386412836597835971462976452813,0.07897839997895062,41,2341,2300
105070308340000076609308201231060789000907000507000604012090560800706002904030807,125679348348251976679348251231465789486927135597183624712894563853716492964532817,0.02600789995631203,39,337,298
200459001150302069400106003310547098700000004804000507541803976000010000903705102,236459781158372469479186253312547698765298314894631527541823976627914835983765142,0.08056870003929362,38,1903,1865
040100009810309004509400610100000805300904001708000006051002908900806053600001040,246157389817369524539428617124673895365984271798215436451732968972846153683591742,0.19104580004932359,45,6277,6232
471293506050100009369000020104309600090600018607502900812000070030700002746825103,471293586258167349369458721124389657593674218687512934812936475935741862746825193,0.02615530003095046,37,96,59
100030008360109027009508400501302709782000135603000802815000976000906000906871204,154237698368149527279568413541382769782694135693715842815423976427956381936871254,0.03366479999385774,37,628,591
000060389300009040498000170100006508020030010907500003012000964040600001869050000,251467389376819245498325176134276598625938417987541623512783964743692851869154732,0.40616770001361147,46,15162,15116
240361095058020360009000100702906408000000000095782610521000784000807000806254901,247361895158429367369578142712936458683145279495782613521693784934817526876254931,0.03402409999398515,39,577,538
400050009286040357009267800100000004060090030895010276310000098600000002902781403,471358629286149357539267841123576984764892135895413276317624598648935712952781463,0.08766220003599301,41,2724,2683
400030009520070046093000720100000004050781090870090052041000960000607000765943218,417236589528179346693458721139562874254781693876394152341825967982617435765943218,0.04953519999980927,42,1171,1129
200040789400000000389000610120007508570000023608500047012000856000000002946050001,251346789467189235389275614123497568574618923698523147712934856835761492946852371,0.09923940000589937,45,3010,2965
200130409100000003300060580002306908080010040507402300021040005800000004906053002,258137469164598723379264581412376958683915247597482316721649835835721694946853172,0.17581769998650998,46,5797,5751
210345098307080406090206050000000000570090061980060042001050800000804000805637209,216345798357189426498276153164523987572498361983761542631952874729814635845637219,0.06853869999758899,43,1937,1894
100329008008060900360501072500402009400010005603807104714000356000000000836145297,147329568258764913369581472571432689482916735693857124714298356925673841836145297,0.03043889999389648,39,462,423
400210396168009002293060080300700009020190068800500001631020050782005004900670823,457218396168359472293467185316782549524193768879546231631824957782935614945671823,0.03785000002244487,38,519,481
350460290200000100070080005520608009100090002600201073700040080005000004046029031,351467298268935147479182365523678419187394652694251873712543986935816724846729531,0.25759170000674203,46,8649,8603
260070483310000009570340002100000900080090030007000005700052094800000057956030021,269175483314628579578349162123567948485291736697483215731852694842916357956734821,0.46046560001559556,46,16314,16268
310240580008009060009708124000001708190087036000002901001604895004003070970820410,317246589428159367569738124642391758195487236783562941231674895854913672976825413,0.05793690000427887,39,1591,1552
020050090406139205590268034000000000160090027049080360670010059000000000854020713,321457896486139275597268134235671948168394527749582361672813459913745682854926713,0.45332950004376471,42,16123,16081
030020090200000003460138027302070409780050016090301080021060970000080000976010835,137425698258697143469138527312876459784952316695341782821563974543789261976214835,0.03223390004131943,42,548,506
240378019100000008000156000003060900060893050095010640001934800600000004974080235,246378519157249368389156427713465982462893751895712643521934876638527194974681235,0.05802990001393482,42,1437,1395
210349086450000039060852040106070805080090020004010600001724900000605000805030402,217349586458167239369852741126473895783596124594218673631724958942685317875931462,0.02385499997762963,42,87,45
240009351150302809000000002012006905597810030083005704000000008830901507960007123,248679351156342879379158642412736985597814236683295714721563498834921567965487123,0.03426070004934445,39,407,368
138050794260407035500391006307040902080070040090000070700000009903802507856000423,138256794269487135574391286317648952682975341495123678721534869943862517856719423,0.04187019995879382,39,846,807
246007891100000003300068024000006310000020000097800000860470009700000005935600748,246357891158249673379168524482596317513724986697831452861475239724983165935612748,0.30633829999715090,46,10229,10183
158040379200307005400598001006179400080060090004805100000000000900684007847000536,158246379269317845473598621326179458581462793794835162612753984935684217847921536,0.16077229997608811,42,5148,5106
137050689200109037500070001070006004406510020050007006600020005700805063985030472,137452689248169537569378241371286954496513728852947316613724895724895163985631472,0.03454709996003658,40,631,591
053080120100402003200105006302746905006913200090000030800364007900000002647020318,453687129168492753279135846312746985586913274794258631821364597935871462647529318,0.03007490001618862,40,418,378
451020738270000049000457000100000006800236007060000020600348005730905082985060413,451629738276183549398457261123574896849236157567891324612348975734915682985762413,0.04745979997096583,40,962,922
007300801050209307300000040504062908600000003701580406010000009805907030906004100,247356891158249367369178245534762918682491573791583426413625789825917634976834152,0.09085009997943416,45,2855,2810
000367008300100057200095003691200004500780631783600009400036002800900045000542006,154367298369128457278495163691253784542789631783614529415836972826971345937542816,0.08636630000546575,41,2141,2100
108050007060308512000000308300840005590610284800590006000000809050901643903020001,138259467469378512275164398316842975597613284824597136641735829752981643983426751,0.17585669999243692,42,5590,5548
340506009000200067209000005000002803780154092905800000400000908570001000800407021,347516289158249367269378145614792853783154692925863714431625978572981436896437521,0.09697319997940212,46,2862,2816
300150802020400067500000000210045006480020075900360021000000008790004050804073009,347156892128439567569287134213745986486921375975368421631592748792814653854673219,0.45014729996910319,46,15951,15905
400030008210576049009000200100387005370090012906020407040000060650903081700861004,467239158218576349539418276124387695375694812986125437841752963652943781793861524,0.02871210000012070,41,377,336
371200009000519087000000100105370806290480705708950402000000600000124058954800001,371248569426519387589637124145372896293486715768951432812795643637124958954863271,0.02254550001816824,41,89,48
504317608060209010109000203806020904230000086407080301040000070700801009903475102,524317698368249517179658243816723954235194786497586321641932875752861439983475162,0.02337070001522079,39,207,168
300248009020519080509000104105372806200406005000000000010000040607104908954803271,371248569426519387589637124145372896293486715768951432812795643637124958954863271,0.02529850002611056,40,286,246
340056092000409067509200000210005000406000305000300021000002708790804000850670019,347156892128439567569287134213745986486921375975368421631592748792814653854673219,0.24541699996916577,45,8475,8430
253400107000508204000000000310006905620090071904700026000000000802901000709003512,253469187196578234478132659317286945625394871984715326531627498842951763769843512,0.42372039996553212,46,15288,15242
154267839000109207000000000400500900683092501700800300000000000000405602846923715,154267839368149257279358164412536978683792541795814326527681493931475682846923715,0.13917810004204512,42,4362,4320
137400082208070006640000000310500000705090803000007024000000095800020407590001268,137456982258179346649238751314582679725694813986317524472863195861925437593741268,0.15348720003385097,46,5052,5006
158346972200070003000108000402000509003090100590401026700050008800704001946000735,158346972264579813379128654412637589683295147597481326721953468835764291946812735,0.05080520000774413,41,884,843
435071982100050006000008003210503009006197008890406001000002005500010007983065214,435671982128359746679248153214583679356197428897426531741932865562814397983765214,0.02496110001811758,40,247,207
035481960100392008400000001000705000604020305050609020501000406700010002068254710,235481967176392548489567231312745689694128375857639124521873496743916852968254713,0.06356540002161637,42,1787,1745
354179268100283005000000000500010009613704852900000003400801006800060004769040381,354179268176283945298456137542318679613794852987625413425831796831967524769542381,0.06947799999034032,40,1720,1680
037048596100060004000500028300604000086917432700802000000700063600080009075026841,237148596158269374469573128312654987586917432794832615841795263623481759975326841,0.02691759995650500,41,276,235
158267349309415208070000050000000000786090532590602087600703005800000006040826010,158267349369415278472389651213578964786194532594632187621743895837951426945826713,0.03705860004993156,39,719,680
136248597400359008000000000000403000305000401890705032602901803900000006740536019,136248597427359168589167324261483975375692481894715632652971843913824756748536219,0.02345779997995123,40,171,131
236010579100000008000070000000204000542837196790060043600000004800359001025641830,236418579157923468489576312361294785542837196798165243613782954874359621925641837,0.02754079998703673,41,351,310
238146759107309608500070001000407000071692380000010000600905004700000003800734002,238146759147359628569278431352487916471692385986513247613925874724861593895734162,0.02389030001359060,42,223,181
410285697207000005500007014000006000376091842000002000600004078802000001750618423,413285697267149385598367214124836759376591842985472136631924578842753961759618423,0.19181400001980364,41,6277,6236
531246879402080503000070000000703000200891006390020015703000408000010000065437290,531246879472189563689375124146753982257891346398624715713962458924518637865437291,0.03835009998874739,42,638,596
045369107100008050000150006503000800017586923802000500000730008700001030038642705,245369187176428359389157246593274861417586923862913574621735498754891632938642715,0.04675949999364093,41,1077,1036
205369107006000300380050046003274800017586920000000000020030090000891000900642005,245369187176428359389157246593274861417586923862913574621735498754891632938642715,0.09159730002284050,44,2842,2798
351692408060100000070300020126000709000000000904000312010008030000001060805763241,351692478268147593479385126126834759537219684984576312612458937743921865895763241,0.11884780001128092,45,3305,3260
105040609000000000470508013094623150010805040806000307520080094043701860600492001,135247689268139475479568213794623158312875946856914327521386794943751862687492531,0.02499649999663234,39,242,203
301080204000000000480257063023060490000391000806000305000030000038715640705826901,351689274267143589489257163123568497574391826896472315612934758938715642745826931,0.06756120000500232,42,1843,1801
237460108100003000060187034601000905000504016405000703010925067700006000956740302,237469158148253679569187234681372945372594816495618723813925467724836591956741382,0.07211599999573082,39,2040,2001
347651002100000000069370004403000975070903240802000136021430009900000000785169003,347651892158294367269378514413826975576913248892547136621435789934782651785169423,0.03051029995549470,40,145,105
245360701100000040098174026003000052000591073001000094012847035700000060859620407,245369781167258349398174526973486152426591873581732694612847935734915268859623417,0.03107750002527609,38,509,471
105040609000139000400060003704623108000805000806000307001386700900701002680492031,135247689268139475479568213794623158312875946856914327521386794943751862687492531,0.03649000002769753,41,572,531
104237508000198000300050001601324807052801340800070006410000072520000083900040005,164237598275198634389456721691324857752861349843975216416583972527619483938742165,0.04768000001786277,41,1136,1095
204050608100060007006328400341080579000703000800000003000602000528931746907040102,234157698185469327796328451341286579652793814879514263413672985528931746967845132,0.04607409995514899,41,974,933
106040809000309000400000003302060508080102030690000021040000080963854712825731946,136245879258379164479618253312467598584192637697583421741926385963854712825731946,0.02953340002568439,39,407,368
234157008000009000700300450001000079050793010870000200013002005000900000900845132,234157698185469327796328451341286579652793814879514263413672985528931746967845132,0.18091270001605153,46,5937,5891
207419508000627000004000200010040070379162845400000001000804000703951602805070403,237419568958627134164583297512348976379162845486795321621834759743951682895276413,0.14412429998628795,41,4024,3983
146238759000060000009070600020080090670594083800000006000903000038706510764050932,146238759257169348389475621423687195671594283895312476512943867938726514764851932,0.02675590000580996,41,362,321
307261409000050000200070006129604578073185690500000001800702005000506000905813704,357261489618459237294378156129634578473185692586927341831742965742596813965813724,0.18205889995442703,40,5890,5850
251340607007000008400000130104080000070496050000020803016000002700000900508072316,251348697367159428489267135124583769873496251695721843916834572732615984548972316,0.23956419999012724,46,8317,8271
204078509070520004509004012300000807090287036800000405601005078040760003703092601,234178569176529384589634712312456897495287136867913425621345978948761253753892641,0.03462550003314391,39,387,348
107246509008050300009000200000020000302491605000583000020000090003762400764010823,137246589248159367659378214415627938382491675976583142521834796893762451764915823,0.03771969996159896,44,755,711
010050080208000307000070000180040076600080005004601800400905008905010203836724591,317452689248169357569378124182543976693287415754691832421935768975816243836724591,0.04220720002194867,43,908,865
010346080008000200509000306100080009086010520005624800600807002900030008874562193,217346985368159274549278316123785649486913527795624831631897452952431768874562193,0.03832459996920079,41,740,699
030010060106000304409050107300080002672000845805624701000000000020060070964735218,237418569156279384489356127341587692672193845895624731713842956528961473964735218,0.13356820004992187,41,4122,4081
200589601100000248360002000502008000400070009000200106000400057834000002905826004,247589631159637248368142795512968473486371529793254186621493857834715962975826314,0.15924970002379268,46,5032,4986
000358000208000107009000400400572008700090004006843700673080529010000070905736801,147358296258469137369217485431572968782691354596843712673184529814925673925736841,0.04700220003724098,43,1088,1045
107300860400000235039200004201000000390080041000000307800005710913000002056001903,127354869468197235539268174271643598395782641684519327842935716913876452756421983,0.09422839997569099,46,2787,2741
246508370150000600389160500000070804013900005000020703471850900920000400638209150,246598371157432689389167542562371894713984265894625713471853926925716438638249157,0.03411989996675402,39,522,483
001275600060000070079030120100080006430000017007010200610543098050020060984701532,341275689268194375579638124125387946436952817897416253612543798753829461984761532,0.04354850004892796,41,893,852
100254007040000030079368140320407068407000302000020000610705083700040009980632051,136254897548179236279368145325417968497586312861923574612795483753841629984632751,0.03584490000503138,40,639,599
107040509500000007349508216270403095401907302080000070602704908004050600030692040,127346589568129437349578216276413895451987362983265174612734958794851623835692741,0.02931839996017516,38,391,353
050030090200000007400507008345601879791000265800000003502403906683050741910070032,157238694268149357439567128345621879791384265826795413572413986683952741914876532,0.03110570000717416,38,476,438
140238070000000803309007004500002048060010090970800001400600902608000000020985016,146238579257149863389567124531792648862314795974856231415673982698421357723985416,0.65637589996913448,46,23951,23905
050137090300402007400000008140050089683000524700000001500208003824000675907645802,258137496369482157471569238142356789683791524795824361516278943824913675937645812,0.02643760002683848,40,198,158
030154080100000007400708001071080590680000074500000002803906405725301968946020713,237154689158269347469738251371482596682593174594617832813976425725341968946825713,0.03408710000803694,38,613,575
146038070050009003309507004000002008802000705900800000400603902600400050020980416,146238579257149863389567124531792648862314795974856231415673982698421357723985416,0.76971099997172132,45,19649,19604
145387060260000500009002001402050807703018640806070103001006004930000700678495010,145387269267149538389562471412653897793218645856974123521736984934821756678495312,0.06222419999539852,39,461,422
147389526008621400000000000000030000005106800980070041820050064700000005596714283,147389526358621479269547318612438957475196832983275641821953764734862195596714283,0.05251419998239726,41,353,312
307268159000000030500004060001080006403906502800020700010700004020000000734891605,347268159162579438589134267251387946473916582896425713618752394925643871734891625,0.13165240001399070,45,1803,1758
307246509240309067500070004400090003103000605706010802600407008000000000974865321,317246589248359167569178234485692713123784695796513842631427958852931476974865321,0.10501299996394664,40,1173,1133
106457298450000000009060050010020879605003401090010536001080040920000000807395162,136457298458239617279168354314526879685973421792814536561782943923641785847395162,0.08262649999232963,40,1032,992
106237589200000000370480010010090003483700902090020008820910070900000000705842391,146237589258169437379485216512698743483751962697324158824913675931576824765842391,0.06392719998257235,41,671,630
301040608009178300070060020000090000500806002800020007602030705000902000945687231,351249678269178354478563129124795863537816942896324517682431795713952486945687231,0.39382369996747002,44,7349,7305
147035098050000300369070050010350009605802104080710006521080060030000900896043012,147235698258169347369478251412356879675892134983714526521987463734621985896543712,0.03996300004655495,39,134,95
200137008107000304098050270000070000403000806600304005721000659030060080860921037,246137598157289364398456271512678943473592816689314725721843659934765182865921437,0.33446029998594895,42,6340,6298
208369071070040203506170040010090007405000329090080004801630090050020806904851032,248369571179548263536172948312495687485716329697283154821637495753924816964851732,0.02385589998448268,38,114,76
206307089300000472079200160080500004503006728060900005035700840600000957807605031,216347589358169472479258163182573694593416728764982315935721846621834957847695231,0.08287419995758682,39,1274,1235
200367009300000006080040030037050260560010094002608300006000500040805070753426981,214367859375189426689542137137954268568213794492678315826791543941835672753426981,0.04042919998755679,42,421,379
350478069200000003000302000123506487700010006004000500802000305036921870947030621,351478269268159743479362158123596487785214936694783512812647395536921874947835621,0.03192340000532568,39,87,48
407008060002060004003407028230600905164090287750800603001904056005010002806003090,417238569582169374693457128238671945164395287759842613321984756945716832876523491,0.07216659997357056,40,1163,1123
257106839000000000030208050370802091081050320500000004000000000025931460946587213,257146839168395742439278156374862591681459327592713684813624975725931468946587213,0.03001630003564060,40,138,98
147250890360008070000300060230000600416930028790000300000400080670009010854720930,147256893362198475589374162235817649416935728798642351921463587673589214854721936,0.03896729997359216,42,176,134
261358490070100060508007000120000609030080245850000701302004000080600010746813950,261358497473129568598467123124735689637981245859246731312594876985672314746813952,0.02324199996655807,40,167,127
006471500000602000000000000002754900097080420680000015700040009843965271960217034,236471598158692347479538162312754986597186423684329715721843659843965271965217834,0.06149629998253658,41,1067,1026
240050018050209060060107050012030790400902005900010003800070009034801570795020831,247356918158249367369187254512438796473962185986715423821573649634891572795624831,0.07434739999007434,40,1654,1614
100269008000103000670000012421356897007000600000714000500030009013080260894020735,135269478248173956679548312421356897357892641986714523562437189713985264894621735,0.05478900001617149,41,970,929
008063279160000000203059068300000807002791034600000501704036052920000000005042716,458163279169278345273459168341625897582791634697384521714836952926517483835942716,0.03427360003115609,41,427,386
140038596250009300309000002400690800682000059700820600503000008920001700870056231,147238596258169374369547182431695827682713459795824613513472968926381745874956231,0.14833260001614690,40,4742,4702
306240580087005200000000004050030047603104902890070060200000000005800620068023705,316247589487915236529368174152639847673184952894572361231756498745891623968423715,0.20504830003483221,45,6690,6645
130426058208319406000000000300050007502080604006147200000000000043090780985060342,137426958258319476469578123314652897572983614896147235721834569643295781985761342,0.11417369998525828,42,3580,3538
300241000027089405008500003002050098800000007930020100200005900503910870000472001,365241789127389465498567213712654398854193627936728154271835946543916872689472531,0.50250169995706528,45,16339,16294
060379080178456239000000000380060057500000006090815020600000008023687540804030702,265379184178456239439128675381264957542793816796815423617542398923687541854931762,0.02009419997921214,41,88,47
060247080209308405400000002390070024501000703027934510900000008034020950708090201,165247389279318465483569172396175824541682793827934516912753648634821957758496231,0.05792529997415841,40,1444,1404
140238096208169304000000000431090827600000009005824600500000008026080740804050201,147238596258169374369547182431695827682713459795824613513472968926381745874956231,0.08669810002902523,41,2478,2437
010256030208147609000000000170060098300090006000718000700000005043925760956070423,419256837238147659567389214172463598384592176695718342721634985843925761956871423,0.04950939997797832,42,804,762
350281069002509300400000002214738956600000008078020140500000004040010020896050731,357281469162549387489367512214738956635194278978625143521873694743916825896452731,0.03275690000737086,40,361,321
140256093050070020000000000570000034403000902092030170800000005020618040936547281,147256893358179426269384517571892634483761952692435178814923765725618349936547281,0.06618429999798536,42,1114,1072
581000379032090840000000000100060004200804003047512690403000907020781030806439201,581246379632197845794358162158963724269874513347512698413625987925781436876439251,0.03374879999319091,40,66,26
365040289018050470400000005120406057500791003007523100001070800000000000746802591,365147289218359476479268315123486957584791623697523148951674832832915764746832591,0.05399159999797121,40,709,669
218050497069172380500000002180503029020090050095060830000020000900000003850934016,218356497469172385573489162186543729324897651795261834631725948942618573857934216,0.03246560000116006,41,161,120
040137080068040370300000002610000053450000096003615700000703000830020067796854231,245137689168249375379586412617492853452378196983615724521763948834921567796854231,0.19729019998339936,40,5125,5085
040209030358040279200000004010080090406513807073060410004000500030020060981605742,147259638358146279269378154512487396496513827873962415624791583735824961981635742,0.02457700000377372,40,228,188
205010306090020080300000004002306800503000602069040150700000008030971020954238761,245817396196423587387695214412356879573189642869742153721564938638971425954238761,0.14964469999540597,42,3903,3861
108076093060000020000300006090064570601507902087920040800002000020000060730840209,158276493369418725472359186293164578641587932587923641814692357925731864736845219,0.16629449999891222,45,4201,4156
347009082000270500000008007602000078403090605790000204800900000004081000970400851,347569182168274593259138467612345978483792615795816234821957346534681729976423851,1.41757619997952133,46,51468,51422
417206080508070042300400007000700008270000031800004000600003004940080103050901826,417236589568179342329458617135792468274865931896314275681523794942687153753941826,0.03021310002077371,45,459,414
100207005302010408570000031003705900405090307000823000700000003030681050856372149,148237695362519478579468231213745986485196327697823514721954863934681752856372149,0.15591989998938516,40,5395,5355
200137009167080423000000000410306078653010942090425030000000000030070060076802310,245137689167589423389264751412396578653718942798425136521643897834971265976852314,0.05714749998878688,42,1477,1435
000258000460070083500000007030000090246090875908040201091000740003010900854967312,317258469462179583589436127135782694246391875978645231691523748723814956854967312,0.01926289999391884,41,57,16
400356189109000007500000000300700594604015823800400671900000000208000005700839412,427356189169284357583197246312768594674915823895423671931542768248671935756839412,0.10927549999905750,42,3461,3419
207356108108090306300000007000603000586020731700080002800000005024010680670839014,247356198158297346369148527412673859586924731793581462831462975924715683675839214,0.08551229996373877,41,2576,2535
206300091048200007309040050400068000682093504700012000501020030027600005804900026,256387491148259367379146258413568972682793514795412683561824739927631845834975126,0.06481160002294928,42,1843,1801
230456018158020476460080053300208009504010807600000004000090000005060300840030092,237456918158329476469187253371248569594613827682975134713892645925764381846531792,0.21107469999697059,42,7399,7357
250360091067280004309040006500003000743016508800002000901030005078520003430790012,254367891167289354389145276512873469743916528896452137921634785678521943435798612,0.04644669999834150,40,1145,1105
305208609200050008498060125000506000807090203960000014001030900040080050780615032,315248679276159348498367125134526897857491263962873514521734986643982751789615432,0.04586979997111484,41,1071,1030
300248009206050308498000125130506097807090203900000004000734000040080050780010032,315248679276159348498367125134526897857491263962873514521734986643982751789615432,0.02625840000109747,41,342,301
216438009007250108500000000600080405403506812900020607700000000004960701169875004,216438579347259168598617243621783495473596812985124637752341986834962751169875324,0.07604970003012568,40,2271,2231
253647809000000274470002000300060095600905103700010068520006000000000687846791502,253647819168359274479182356312468795684975123795213468527836941931524687846791532,0.08134370000334457,40,2465,2425
201359478080100030703000050124005007300908601896001005407000080030700060602894713,261359478589147236743286159124635897375928641896471325417563982938712564652894713,0.05709699995350093,38,1455,1417
306200840020450760400800102013007580600523007097008230800900405040380690905700320,356271849128459763479836152213697584684523917597148236831962475742385691965714328,0.02104860002873465,38,106,68
057306029100000057200007000010005700570148032004700010000500008630000005740802390,457316829163289457289457163312695784576148932894723516921534678638971245745862391,0.22937480005202815,46,8169,8123
006305789430190056500000004000002005090418020800900000300000008750069013984701500,216345789438197256579286134143672895695418327827953641361524978752869413984731562,0.08067250001477078,44,2316,2272
300209750460050832000000106006000980240398560005000240000000408750040619900706320,318269754469157832572483196136524987247398561895671243621935478753842619984716325,0.06693180004367605,42,1844,1802
100047809000000420400308000030070198600924003795010040000702004067000000802650001,156247839378195426429368517234576198681924753795813642513782964967431285842659371,0.13611319998744875,46,4504,4458
401030709302090406500408003614302895720080064030050010000503000073010540050709030,461235789382197456597468123614372895725981364839654217146523978973816542258749631,0.03748759999871254,40,750,710
240030089150070024300208005400306007605090203093821450000000000930784062070502030,247135689158679324369248175412356897685497213793821456526913748931784562874562931,0.03822899999795482,40,719,679
105389706006000500200507003450603097001000300063070250017020630024030970809706402,145389726376142589298567143452613897781295364963478251517924638624831975839756412,0.03734759998042136,39,722,683
157040368308000402400308001270080039080000040094713820700534006035020710000901000,157249368368157492429368571271485639583692147694713825712534986935826714846971253,0.03099419997306541,40,479,439
247090186058000430300108007470080065000901000003070800800562003920734018006809500,247395186158627439369148257471283965682951374593476821814562793925734618736819542,0.02687689999584109,40,312,272
105678209000000000208504607400090003003801900080362040600050008014020750709486301,145678239376219584298534617421795863563841972987362145632157498814923756759486321,0.04241880000336096,41,880,839
100249308000100002409300001201085039080602147604013025702500006000800004800971203,157249368368157492429368571271485639583692147694713825712534986935826714846971253,0.06887199997436255,39,1819,1780
260000038000802000380070015410000097090705040003149600540203076800010004907654801,264591738175832469389476215412368597698725143753149682541283976826917354937654821,0.06603809999069199,41,1814,1773
231050798057108460400000001000609000670201039009040600510803046040060080806514307,231456798957128463468397251125639874674281539389745612512873946743962185896514327,0.03092859999742359,39,493,454
307054089000069037600300024700543000000000000000712003460001005970820000180470206,317254689248169537659387124721543968534698712896712453462931875975826341183475296,0.19540290004806593,45,6697,6652
305217408000000035109050006402063000000902000000180203600030907930000000804729301,365217498278496135149358726412563879583972614796184253621835947937641582854729361,0.44959540001582354,45,16094,16049
204009005000080029300100047510648000040201060000753014420007006970060000600900802,264379185157486329389125647512648793743291568896753214421837956978562431635914872,0.62881349999224767,45,22951,22906
250369078000000000370102094080643020642090853000080000400000007026000940937814562,254369178169478235378152694581643729642791853793285416415926387826537941937814562,0.02762569999322295,40,386,346
371459028000023497200000000003076000029508743005094000400000000000041572957682014,371459628568123497294867135143276859629518743785394261412735986836941572957682314,0.02438959997380152,40,233,193
065217098208000035000050006402063009583900014706084003000030007907000082054729061,365217498278496135149358726412563879583972614796184253621835947937641582854729361,0.06389559997478500,39,1746,1707
009178243102000089000000007206037805357890020908012706000000008704000052005724361,569178243172345689483269517216437895357896124948512736621953478734681952895724361,0.04955099994549528,39,1179,1140
200501008100497006070020050001070200400010009093080540000208000904103807835769412,246531798158497326379826154561974283482315679793682541617248935924153867835769412,0.04986979998648167,41,1233,1192
240305600108000432000080105000036008600509003500870000704020000925000807006704021,247315689158697432369482175471236598682549713593871264714928356925163847836754921,0.13026410003658384,45,4312,4267
006209587208107300009080000002060908680790205003050401001070000805406700007503842,146239587258147396379685124512364978684791235793852461421978653835426719967513842,0.05796589999226853,41,1600,1559
020306490138209507040070010400000003075931600900000001050060030392807106060103270,527316498138249567649578312416785923275931684983624751751462839392857146864193275,0.02628719998756424,41,338,297
000307000309020407478050312100000008000702000697010523010273080700080004806495201,251347896369128457478956312142539768583762149697814523914273685725681934836495271,0.27046740002697334,41,9339,9298
060307040209468301504000608000000000400702006697010423001070800700986002806241907,168357249279468351534129678312694785485732196697815423921573864743986512856241937,0.02499289996922016,40,216,176
230508019015030260800010004900374005400105007587602431000726000300000006609040102,234568719715439268896217354921374685463185927587692431148726593372951846659843172,0.04006149998167530,40,552,512
100200060250069704069078102520000006480502309790000005072041503810053607900700040,147235968258169734369478152521397486486512379793684215672841593814953627935726841,0.07889239996438846,39,1082,1043
247108000300400007109300500700000859400205001596000002001003908900007005000906143,247158396358469217169372584712634859483295761596781432621543978934817625875926143,0.57546620001085103,45,9106,9061
158200006009080107403060002300490005004000600700053009800030704605070900900001863,158247396269385147473169582316498275594712638782653419821936754635874921947521863,0.09484320000046864,45,1715,1670
467209358100080009598000124010000090300108002906030705800060007003020900709841206,467219358132584679598376124214657893375198462986432715821963547643725981759841236,0.10024330002488568,40,2178,2138
317408962208000503509000408120070095604000107005020600800942006002010300900503001,317458962248169573569237418123674895684395127795821634831942756452716389976583241,0.04180750000523403,41,457,416
217348956000060000409207108070000060504080301006090500601904805003070200740801093,217348956358169742469257138872513469594786321136492587621934875983675214745821693,0.06113739998545498,40,1476,1436
210300098007090400400000310600070050804915203090080004032000007005020900960001042,216354798357198426489267315621473859874915263593682174132549687745826931968731542,0.05290770001010969,46,541,495
150368079006109500009070100510080094603412807000050000000706000700524001460000023,154368279276149538389275146512687394693412857847953612921736485738524961465891723,0.04683459998341277,43,633,590
200408009108069000069000008380070014514392706970010032021000005703085000800601003,237458169158269347469137258382576914514392786976814532621743895743985621895621473,0.13218229997437447,41,3592,3551
260147059070309080000000000020406030300792001609010702900604008700020004846070123,268147359471359286593268417127486935354792861689513742912634578735821694846975123,0.04424949997337535,42,666,624
340018009000309148189000200710090002800154607690020004431000700000506481560041003,346218579257369148189475236714693852823154697695827314431982765972536481568741923,0.05309299996588379,39,1128,1089
140206039068104520270000046080060010601020308700901004814030692500010003900040001,145276839368194527279358146482763915691425378753981264814537692527619483936842751,0.02358610002556816,40,118,78
100479068060100507200060403014005000700000005000700320501080004903001080680342001,135479268468123597279568413314295876792836145856714329521987634943651782687342951,0.06884409999474883,45,1838,1793
200583017170000504309100000002300000500219008000006100000004809704000061980621003,246583917178962534359147682412358796567219348893476125621734859734895261985621473,0.08043250004993752,46,1864,1818
106258903057000260200060001030572090700496005000000000570020089609080402020931050,146258973357149268298367541431572896782496315965813724573624189619785432824931657,0.03997639997396618,42,705,663
140235690302009048000486002200347000437000006900612000000854009703001064890763250,148235697362179548579486312216347985437598126985612473621854739753921864894763251,0.02572999999392778,37,199,162
051437980068000140400168005016000490800000001900814002700040003690080014040672050,251437986368259147479168235516723498824596371937814562785941623692385714143672859,0.03841929999180138,41,498,457
005006147040000009009107008076480000402070506000012470700503800800000020964800700,285936147147258369639147258376485912412379586598612473721563894853794621964821735,0.31303520000074059,46,10739,10693
235798106008000239400003508000860000640100023000930000500007904004000765867549302,235798146178456239496213578351862497649175823782934651513627984924381765867549312,0.02365749998716637,40,191,151
106358090500000108008017063300500009060800700705604001400900806002085000003146950,126358497537469128948217563314572689269831745785694231451923876692785314873146952,0.50811070000054315,43,18894,18851
146357280000000063308400700010030807080071640700000000601000000900008506875290310,146357289257189463398462751412635897583971642769824135621543978934718526875296314,0.06248020002385601,44,1523,1479
316240708480000053509308004030400500600000029708500001050010300004000015103007002,316245798487196253529378164231489576645731829798562431952614387874923615163857942,0.85959760000696406,45,32740,32695
137480600008070010400102508300050090084093000700806203020040000000001002576920400,137485629258679314469132578312754896684293157795816243821347965943561782576928431,0.62541320000309497,45,23250,23205
357008269060050730409000005270000403003090070600307000010930000005026001900070308,357148269168259734429763815271685493583492176694317582812934657735826941946571328,0.03466989996377379,46,615,569
157300200000510000309200401000450890500000074790100005830000000000001048645892700,157364289428519637369278451213457896586923174794186325831745962972631548645892713,0.40619810001226142,46,13359,13313
007300109000049020000200403410560800680001000700804001530980674000617008870405902,247356189358149726169278453412563897683791245795824361531982674924617538876435912,0.05150800000410527,42,588,546
100300509000070040004200003400020800807000030263007001610030980005091026970502304,126348579539176248784259163451623897897415632263987451612734985345891726978562314,0.22230639995541424,45,3966,3921
140000300376080050098300601710400503050070040900000807420000900501000086089703104,145267398376189452298345671712498563853671249964532817427816935531924786689753124,0.12432519998401403,44,2990,2946
310200790080090050009008164200400000045730029708500001950010300004000015163807002,316245798487196253529378164231489576645731829798562431952614387874923615163857942,0.06061899999622256,43,977,934
100368209070000800009407016720506100060070040504001007010700900008090721900802003,145368279376129854289457316723546198861973542594281637612734985438695721957812463,0.16991769999731332,44,3794,3750
300156409000230607009007012200604000080970200604008075000860504000001063906043001,327156489418239657569487312275614938183975246694328175731862594842591763956743821,0.15736630000174046,43,3158,3115
200040903060200504071093068120609705090310000600005009010700806705000400800001007,258146973369278514471593268123689745594317682687425139912734856735862491846951327,0.13934479997260496,45,3353,3308
107008069000100200209040051400503002080710006003804005704030008010000003005002614,147258369358196247269347851471563982582719436693824175724631598916485723835972614,0.68611170002259314,46,21166,21120
200703409360050200009000053120306705030090000900504001610800907700040080005002306,258713469361459278479268153124386795536197824987524631612835947793641582845972316,0.03360060002887622,45,539,494
350408792270900600009030051500100908080070000607002004710600409800090020006001037,351468792278915643469237851523146978184379265697582314712653489835794126946821537,0.06373930000700057,44,1605,1561
150008403400030520380009067270310005040090000503006004600900802005040000038605001,157268493469137528382459167276314985841592376593786214614973852725841639938625741,0.07274649996543303,45,1925,1880
358207009100050380470001050200500008080070030706003405800000004000020060635104072,358267149162459387479381256213546798584972631796813425827635914941728563635194872,0.14070970000466332,45,4556,4511
100208309480350100050060040200000003730690480048703062570020904000070020004005817,167248359482359176359167248216584793735692481948713562571826934893471625624935817,0.03619169996818528,42,622,580
100204368320100000069038070200600000070380000900002043630900804040010900805063712,157294368328176495469538271213649587574381629986752143631927854742815936895463712,0.03438010002719238,43,555,512
547109208100000507060000040200003004470500800800427315680700009030000100904001723,547169238129348567368275941215893674473516892896427315681732459732954186954681723,0.13429250003537163,43,4388,4345
007049065200100703560070140402097000003400900705000080000006008020010500904053621,137249865248165793569378142482597316613482957795631284351926478826714539974853621,0.05409459996735677,45,1400,1355
107238059300100400200050080502000008476000300003002046600500804700900205085620731,147238659358169427269457183512346978476895312893712546621573894734981265985624731,0.08188670000527054,42,2150,2108
108507029000000407470030051003085096500000000600900040701094005840016900036052174,168547329352169487479238651213485796594673218687921543721394865845716932936852174,0.02638779999688268,42,251,209
006007095108600403300580026407008009000100700005070061001002007030940600984050012,246317895158629473379584126417268539623195784895473261561832947732941658984756312,0.04167120001511648,44,893,849
407085093100300007500070410001008065306051708005900000600503009030000100052807634,467185293129346587583279416241738965396451728875962341614523879738694152952817634,0.16815019998466596,43,5816,5773
207038069000200437060400280071000005400500600805970000702603058904800700080790014,247138569158269437369457281671324895493581672825976143712643958934815726586792314,0.02309670002432540,42,76,34
305079218260300705100250406001007009602000007000080000500702003800900500937840020,345679218268314795179258436481527369652193847793486152514762983826931574937845621,0.03827520000049844,44,657,613
003409067400100082000270004005008010164900008790010000600004025847305600000860070,213489567476153982589276134325648719164937258798512346631794825847325691952861473,0.15687759994762018,45,5222,5177
305001096000309402200050100001000008400108905096740020608907034720500000054860010,345271896167389452289456173531692748472138965896745321618927534723514689954863217,0.02536899998085573,43,213,170
206048759007009208580070100362007090000600002010020500601004005790005600050060317,236148759147359268589276143362587491475691832918423576621734985793815624854962317,0.06581259996164590,43,1695,1652
138000079007508061560130008001025090400600103090080020800002004704900600010800732,138246579247598361569137248371425896482679153695381427853762914724913685916854732,0.03547329996945336,43,614,571
247300091000209006360000500003001060600700105001620000402007008930800400070514230,247356891158249376369178524593481762624793185781625943412937658935862417876514239,0.26659720001043752,45,9153,9108
007230498000169007530087100040010070300500801090600000602003785700001004984000310,167235498428169537539487126245318679376592841891674253612943785753821964984756312,0.05575870000757277,43,1450,1407
007030680308109502560700000120046090406000305780000100001000058052600000874500061,217435689348169572569728413125346897496817325783952146631274958952681734874593261,0.04304109996883199,44,912,868
107050380008000007300408100000060000605809013000030450021083094730010002890700501,147256389258391647369478125413562978675849213982137456521683794734915862896724531,0.19221709994599223,45,6776,6731
047350100000002079300108200010020000602700031090015604800007406400906002900040800,247359168158462379369178245514623987682794531793815624821537496435986712976241853,0.07494429999496788,46,2184,2138
007256080058001047300400105010060070600809003900100400001080000730915000806700531,147256389258391647369478125413562978675849213982137456521683794734915862896724531,0.04583199997432530,44,1079,1035
108040090004159078300260000010070000903006005080900200031020080840001003690800124,158347692264159378379268451416572839923486715785913246531624987842791563697835124,0.22215340001275763,45,7257,7212
317058460008039057509400300000040800280601034600000005001075042700906000850300900,317258469468139257529467318173542896285691734694783125931875642742916583856324971,0.03140380000695586,43,254,211
207359160008002079300170200014020080602704001700000604021000006030906002970200803,247359168158462379369178245514623987682794531793815624821537496435986712976241853,0.07047209999291226,42,1796,1754
018046070007009082560200104370080000105003207040000003051002008000004005790800301,218346579437159682569278134372481956185693247946527813651732498823914765794865321,0.38298229995416477,46,9048,9002
005060380008029016300108007013290750586700003090000104002840005000002000870605902,125467389748329516369158427413296758586714293297583164932841675654972831871635942,0.03829099994618446,43,186,143
007050280308092076260100405470030090502901007600000502700020000000703004830600700,147356289358492176269187435471235698582961347693874512714528963926713854835649721,0.33804230001987889,45,10070,10025
375028400000000038100306000040070850607004003810200600000763004004802005780000301,375128496462597138198346572243671859657984213819235647521763984934812765786459321,0.06707330001518130,46,1345,1299
348090276002007490500204008010040709003900042097800001020030000004018020750009013,348195276162387495579264138215643789683971542497852361821736954934518627756429813,0.29284049995476380,43,7654,7611
158370600060000040009002003320700098004021006000000001030010900045006087716049002,158374629263198745479652813321765498584921376697483251832517964945236187716849532,0.12327460001688451,46,1869,1823
146230590200000047379008602000010000400090080805706003020001800007004035684305071,146237598258169347379458612762813459431592786895746123523971864917684235684325971,0.06207949999952689,42,699,657
007130508158240060309057002010070809500003000703400005020764900004008020900300486,247136598158249367369857142412675839586913274793482615821764953634598721975321486,0.08037370000965893,42,1286,1244
100250369300090070609300108210080500504020080800009002481000000030005046905703801,147258369358691274629374158213486597594127683876539412481962735732815946965743821,0.15165980003075674,43,3011,2968
250100409360000002479008501120090700084030016007004005000000000005006087746501003,258167439361459872479328561123695748584732916697814325812973654935246187746581293,0.33477259997744113,45,9415,9370
400100692030060000208009003670300805002070010004601007010000000025006034906750201,457138692139267458268549173671392845382475916594681327713824569825916734946753281,3.37541699997382239,46,110490,110444
130200607000000348409000005390601574602480030700005002020000000073006020906802703,135248697267159348489763215398621574652487139714935862521374986873596421946812753,0.22078939998755231,44,7533,7489
130420597457010000000000008310600009006190040800703002620000000003005021905261304,138426597457819236269537418312648759576192843894753162621374985743985621985261374,0.02724899997701868,44,357,313
400200701020049000500000032060008570000090048804702103910070300708003025603820917,436285791127349856589167432261438579375691248894752163912576384748913625653824917,0.14197410002816468,42,4766,4724
210300509050000420000008173020000005006081034000503001030840900042035010705619042,217364589358197426469258173123476895576981234894523761631842957942735618785619342,0.10934650001581758,43,3452,3409
200301690060089040300006002500100800610098037708603001070960500052004010906800024,245371698167289345389456172523147869614598237798623451471962583852734916936815724,0.05063960002735257,42,1309,1267
300170205720000609100000004230400900000080123007002006510690807003001060604725091,346179285728534619159268734231456978465987123897312456512693847973841562684725391,0.03425130003597587,43,595,552
300108260100000070400250081200476008086090020790502003030000900002005036805903142,357148269128639475469257381213476598586391724794582613631824957942715836875963142,0.03013359999749810,42,461,419
200136589150000600000070200401785096080040050700001002004800000036010928802000431,247136589158294673369578214421785396683942157795361842914823765536417928872659431,0.08130879997042939,43,2362,2319
247139056100064309000050002503901024080520007600003001900305000725000010806000005,247139856158264379369857142573981624481526937692743581914375268725698413836412795,0.03944580000825226,43,804,761
240308509130000406800060070300207905070090600000004007700900802920050761005002094,246378519137529486859461273361287945472195638598634127713946852924853761685712394,0.04275719996076077,44,946,902
230100098400080307000070020103000000070500810805013046310900400900860730008000062,237154698461289357589376124123648579674592813895713246316927485942865731758431962,0.16854959999909624,46,5781,5735
258000076160000300000096080400007005010400038003085002500900007830710509907002060,258341976169278354374596281482137695615429738793685412521963847836714529947852163,0.16652500000782311,46,5714,5668
372140009180200304400050000003001005000690200809027036500700000640030700007815042,372146589185279364496358127263481975754693218819527436521764893648932751937815642,0.05298209999455139,44,1200,1156
246007009100200300370168040402003608000000000097012004601705003720800006905020080,246357819158249367379168245412573698563984172897612534681795423724831956935426781,0.07023559999652207,44,1962,1918
300406009200100607000070001102004003680510000005087006700605408930800765006040130,317456829248193657569278341172964583683512974495387216721635498934821765856749132,0.05899589997716248,44,1644,1600
208307506600590100009160270140603809763080000000020007400200905501009040006800021,218347596674592183359168274142673859763985412895421367487216935521739648936854721,0.03185460000531748,42,516,474
107049086200100409000580001302705008000000000004031007923400005740900060605072090,137249586258167439469583721312795648576824913894631257923416875741958362685372194,0.10849110002163798,45,3492,3447
201307806300009500000068040003004905000500023095000084010800009034706008056000031,241357896368429517579168342123684975487591623695273184712835469934716258856942731,0.27975769998738542,46,9812,9766
256000089100500006000080000312008705500000308000065042600903074037800001005071920,256137489178549236493286517312498765564712398789365142621953874937824651845671923,0.28965809999499470,45,10251,10206
105006089270100300080050000007008062500004801028015003701900008960800400004061090,145236789276189354389457126417398562593624871628715943751942638962873415834561297,0.15087710000807419,45,5061,5016
137204509200170300400085010000000001310000608792016035021400053003500006805000040,137264589258179364469385217586943721314752698792816435621497853943528176875631942,0.05084010004065931,43,1246,1203
147000085250009706060070000000300679003400002086090041030804007020000500705023418,147236985258149736369578124412385679973461852586792341631854297824917563795623418,0.02711690001888201,44,342,298
056008293100025708200030050001007049500100607004090032000950004820300900047061020,456718293139425768278639451361287549592143687784596132613952874825374916947861325,0.03059509996091947,43,487,444
007036085200009006000070100012080079900400002006000041601800007820000500795623418,147236985258149736369578124412385679973461852586792341631854297824917563795623418,0.04353720002109185,44,981,937
007005869100009407060080000001020083000900206690070054004002008820700600930041720,247135869158269437369487512471526983583914276692378154714652398825793641936841725,0.05210699996678159,45,1271,1226
000008069300100802200300740400082607706401003009030000001804006000006504670950020,145278369367149852298365741413582697756491283829637415531824976982716534674953128,0.02577420003945008,46,300,254
007008061100009304060070000012000057700500109985010032501406003670900500890035210,247358961158269374369174825412893657736542189985617432521486793673921548894735216,0.03658989997347817,42,704,662
000108029300009006190270000006000080405800001930500064001000005703905600859020743,567138429382459176194276358216394587475862931938517264621743895743985612859621743,0.03407829999923706,45,615,570
007348096500100003000050041401070059300005607060910002003001000200506700900030125,127348596548169273639257841481672359392485617765913482853721964214596738976834125,0.04709350003395230,45,1107,1062
206400019107309048000127005700000000800000506090780102301005090970602400560070820,236458719157369248489127365712536984843291576695784132321845697978612453564973821,0.02671369997551665,43,307,264
047006098108009076060080400002090040800605002090270500001050000600802000780964231,247536198158429376369187425512398647873645912496271583921753864634812759785964231,0.04309340001782402,44,1050,1006
000040098008009760060500042070680005502407306680290000801730009900801000040950801,217346598458129763369578142174683925592417386683295417821734659935861274746952831,0.08228380000218749,43,2422,2379
050000379300100245407300008010040690604507003730810002105000034900600001040000706,251468379386179245497325168518243697624597813739816452165782934972634581843951726,0.10030970000661910,44,3202,3158
040050098300009017200108403001090080602001509090080100063000000904805000520006801,146357298358429617279168453431592786682741539795683124863214975914875362527936841,2.06624430004740134,46,79404,79358
010320598200596047500100000042070800603005072790004613000000004900000005050700301,416327598238596147579148236142673859683915472795284613327851964961432785854769321,0.20101110002724454,45,6736,6691
000056398008009047300470105501040060406003002070090403003002054700501006980000200,247156398158329647369478125531247869496813572872695413613982754724531986985764231,0.02460399997653440,44,203,159
140230987000070060300008000010040000024001008803600405002900871900702003780300200,146235987258179364379468152517843629624591738893627415432956871961782543785314296,0.26900169998407364,46,9276,9230
358170629009030070400506000010040907600017003500002100020053000805009041900700502,358174629169238475472596318213845967684917253597362184721453896835629741946781532,0.03409010003088042,44,629,585
060180394407320080900406002020030760000001005800004210001060030002003057700800600,265187394417329586938456172124538769376291845859674213541762938682913457793845621,0.05869099998380989,46,1493,1447
040350809208000070300200005431020000002903068000005200700000984604001003890734600,147356829258149376369287145431628597572913468986475231713562984624891753895734612,0.06514030002290383,45,1814,1769
410350802208090050500408007172043000304001075090000300021030904900004008740200500,417356892238197456569428137172543689384961275695872341821735964953614728746289513,0.03127350000431761,43,530,487
540820309000079040300105000180050600003060002690000003700002980905601004836790500,541826379268379145379145268182453697453967812697218453714532986925681734836794521,0.04642029997194186,44,1119,1075
140530209200060073360001005410053700000004002800020354000040907004002036730800400,147538269258469173369271845412653798573984612896127354621345987984712536735896421,0.19752119999611750,44,7132,7088
040260305000080090300407002410020600006005004708340251070000900900804006854600703,147269385562183497389457162415728639236915874798346251671532948923874516854691723,0.05266009998740628,44,1330,1286
030270904007090050500406002410060528005001093080000107000050000704002001860307205,136275984247198356598436712413769528675821493982543167321654879754982631869317245,0.45483800000511110,45,16816,16771
230548197000000020150206003010080700005307008700602300500060000903004001680750932,236548197847139526159276483312485769465397218798612345521963874973824651684751932,0.17810800002189353,43,6137,6094
147060090300109006069078000000003087800400903090080040901007054400010870786004039,147265398358149726269378415514693287872451963693782541921837654435916872786524139,0.17117759998654947,43,6151,6108
240710308000000740009408002010380400000024001800590200020030000907006025680972100,246719358158263749379458612512387496793624581864591273421835967937146825685972134,0.05050690000643954,45,1200,1155
240130609068270400000408000400080063302050001600041270000000800004003057956807004,247135689168279435539468712471982563382756941695341278713524896824693157956817324,0.02787890000035986,44,418,374
251463709060070200009508030000080400000000023600004008902050804735800062806000001,251463789368179245479528136123685497584917623697234518912356874735841962846792351,0.03402970003662631,45,644,599
305678402700120000000005087020000000030080014009007035670830509903054021104000003,315678492748129356296345187421593768537286914869417235672831549983754621154962873,0.18453969998518005,44,6423,6379
300256709069070000572004006230060508456000000807003000013720000904000057700640001,348256719169378245572194836231467598456982173897513462613725984924831657785649321,1.16910679999273270,44,45488,45444
250307000430060020600258001100506080080090314307004002810000549703005060900000003,251347896438169725679258431124536987586792314397814652812673549743925168965481273,0.08266750001348555,44,2458,2414
305208700027690000400007026270000604080000070904006038510830460702000080806901003,365248719127693845498157326271385694683419572954726138519832467732564981846971253,0.19678959995508194,43,6918,6875
250104609376520100400008025100000000080000517700001063830010940501060030900800701,258134679376529184419678325123756498684392517795481263837215946541967832962843751,0.05975989997386932,43,1627,1584
350200700000090050470008020200005008687012034590004071740800305002000047830009002,356241789128397456479568123214735968687912534593684271741826395962153847835479612,0.14177670003846288,44,4814,4770
204300609060149000000200034400680000820091705006003002700805406000010087948006051,214358679367149528589267134475682913823491765196573842731825496652914387948736251,0.08059730002423748,43,2423,2380
251308007060100003300060040100780506570093401680000072700020650825000010900001038,251348967467159823398267145134782596572693481689415372713824659825936714946571238,0.02057489997241646,42,111,69
210309056450100020000050019300006004740000105506002003120600807830000040967004031,218349756459167328673258419391576284742983165586412973124635897835791642967824531,0.08542159997159615,43,2608,2565
914006007350100204608030090100600009240090500009004003400800906000040030893065410,914256387357189264628437195135672849246398571789514623471823956562941738893765412,0.06679090001853183,44,1903,1859
107068009000100000209057010300800004080270900604003072710900506000030090946085020,157368249468129735239457618372896154581274963694513872713942586825631497946785321,0.10725580004509538,45,3377,3332
201007609468130000000000030300604908020090700007005003100903507000010000786500391,231457689468139275579268134315674928824391756697825413142983567953716842786542391,0.06131499999901280,46,1635,1589
300046008408100300000070024000502007090780401003000002600904785970010003845007019,317246598428159376569378124184562937296783451753491862631924785972815643845637219,0.06867379997856915,44,1923,1879
405008209120300500000056040200003097750000600084017002500820004800000020692034015,465178239128349576379256148216583497753492681984617352537821964841965723692734815,0.24185079999733716,44,8397,8353
107246009200300000060050007001405002590780604084000053700500060825030900906001025,137246589258397146469158237371465892592783614684912753713529468825634971946871325,0.25045650004176423,43,8807,8764
257009008100400009049070060006003007030000801005004006501900604080540000674021093,257369418168452739349178265416283957732695841895714326521937684983546172674821593,0.31610419997014105,45,11441,11396
308027409100409008000080010200005807080900602003070145720603904930010700006700051,358127469162439578479586213214365897587941632693278145721653984935814726846792351,0.02462919999379665,42,217,175
453067090100200000079050060300004009090306204084020017921803000730600900006000030,453167892168239475279458163312784659597316284684925317921873546735641928846592731,0.07794779998948798,45,2215,2170
235107009140060207079080100000006002080590301002003064800004000920000000504901028,235147689148369257679285143351476892486592371792813564817624935923758416564931728,0.92395959998248145,45,35165,35120
207000039300204000069087000000008692500000703093020005010605028700010906806003071,247156839358294167169387254471538692582469713693721485914675328735812946826943571,0.31350690004182979,45,11623,11578
047009080100400007083760190306504009020100803000020051601005008932800600804070012,247319586169458237583762194316584729425197863798623451671235948932841675854976312,0.02260939998086542,42,205,163
246007083150000002009028100000004059400000600097060000804502096920600300760040021,246157983158396472379428165631784259482915637597263814814532796925671348763849521,0.18147429998498410,45,6448,6403
106035089300409001090060000000004008810000205005010040401028007650903000789040523,146235789327489651598167432263754198814396275975812346431528967652973814789641523,0.12770940002519637,44,4330,4286
368001579100809002500060008203008005480000900605023010000000006700900301956034080,368241579174859632529367148213498765487615923695723814831572496742986351956134287,0.16319589997874573,44,5452,5408
010050020090026005050009310020030078500800102080007034801002097700900850065083041,416358729397126485258479316124635978573894162689217534831542697742961853965783241,0.06323480000719428,43,1750,1707
147030080200109003060000000003597026570600001000010050631040098920003400004020065,147236589258179643369458172413597826572684931896312754631745298925863417784921365,0.02234960003988817,45,149,104
301000080207300004480150200000907500600510803508040000702435008930800400800020315,351274689267398154489156237123987546674512893598643721712435968935861472846729315,0.06990400003269315,43,2092,2049
207064050100009004060385002010090007300840005090702000901030070600000409045020831,237164958158279364469385712514693287372841695896752143921438576683517429745926831,0.10897850000765175,45,3155,3110
107008095200009007060000000401020006380906100690050430703000084820000609056084723,137468295248519367569237841471823956385946172692751438713692584824375619956184723,0.06190929998410866,43,1732,1689
106290048300008006080000000237004050800000160560000000605802093720041605048035710,156297348379418526482356971237164859894523167561789234615872493723941685948635712,0.02841730002546683,43,424,381
100036090058004007260007010401080070570301002090000300603000059720009800980073104,147236598358194267269857413431982675576341982892765341613428759724519836985673124,0.11480320000555366,44,3814,3770
040320580008009007300400602032090070000704006690200450900002060800900200700653198,146327589258169347379485612432596871581734926697218453913842765865971234724653198,0.03876830002991483,44,833,789
257060090061009008490300006020080030603094001980003700500070063800500900740900280,257168394361429578498357126124785639673294851985613742519872463832546917746931285,0.04266209999332204,44,946,902
340210060009057000570300104000070030250004001600000200004020386800706009900840752,348219567169457823572368194491572638253684971687193245714925386825736419936841752,0.03345670003909618,45,631,586
040326059008000007269507004070030020002001073600000500000050742900708600730260108,147326859358149267269587314471835926582691473693472581816953742924718635735264198,0.02950629999395460,44,451,407
046310080150000300300406007010060030900000005700000200501870690800601700600543810,246317589157289346398456127412765938963128475785934261531872694824691753679543812,0.08863279997603968,46,2818,2772
010340089008069002460208531030010060000902047704600200000030090900700000600894123,217345689358169472469278531532417968186952347794683215821536794943721856675894123,0.04132740001659840,43,871,828
060230489008009007400008003280050076600001002700600100002000630900810004540300891,165237489328149567479568213281453976694781352753692148812974635936815724547326891,0.03232380002737045,45,586,541
460037050070049020500068307210070860007000005849000200001950080900700100700320504,468237951173549628592168347215473869637892415849615273321954786954786132786321594,0.02679950004676357,44,397,353
030270810000040265500000007380050020007003008600800104712080000900001002860930501,436275819179348265528196347381459726247613958695827134712584693953761482864932571,0.52629820001311600,46,19825,19779
040360590000009306360005027080000960020093084703000010402006850800000431900810602,247361598158279346369485127584127963621593784793648215412736859876952431935814672,0.12153019994730130,43,4108,4065
250160390001009070408000106020080009603004001985603702009070060800500017740900205,257168394361429578498357126124785639673294851985613742519872463832546917746931285,0.02579330001026392,42,341,299
150247830000050260400000105830090700000072008267000901603920080005000093900730602,156247839379158264482369175834591726591672348267483951613924587725816493948735612,0.12609119998523965,43,3903,3860
060107405009040863003009002302000900080070016607003004000500608904000051850320709,268137495179245863543689172312456987485972316697813524721594638934768251856321749,0.08676519995788112,44,2800,2756
100006709200080145409007026610000507098670000004001038500000200000050060807403901,135246789276389145489517326612834597398675412754921638563198274941752863827463951,0.04593570000724867,45,1099,1054
130409078400370169209608003380700600000030000507000002800100920010000006905867001,136459278458372169279618543381724695692531784547986312863145927714293856925867431,0.14990620000753552,44,5053,5009
190274008400080009250096000603000702000030860809000035300805906700010080905607013,196274358437581629258396147613458792524739861879162435341825976762913584985647213,0.05703359999461100,43,1564,1521
140300002000410637009087014501800200000050009602074008910508000005030001806740905,147365892258419637369287514571893246483652179692174358914528763725936481836741925,0.07045709999511018,43,2046,2003
300106005108070620060050100602000009080790000705080014500000438006045791970803500,347126985158479623269358147612534879483791256795682314521967438836245791974813562,0.02754889999050647,43,410,367
200001009100090307360408020500700008090080000702004063620030904000027806805609231,247351689158296347369478125513762498496583712782914563621835974934127856875649231,0.18518880003830418,43,6540,6497
301200007460100500079000000120007806080510300007006014700000465900000081846701932,351248697468179523279365148123497856684512379597836214712983465935624781846751932,0.15471009997418150,43,5362,5319
008009367300200090470000082105004009700000500003007020000703908800920706690085030,258149367361278495479356182125634879746892513983517624512763948834921756697485231,0.10357330000260845,46,3199,3153
207100089600003204000280016100005008500600400006002030820907045004000820765020193,247156389618793254359284716172345968583619472496872531821937645934561827765428193,0.05596700002206489,43,1467,1424
365201089120300000070560032203000006050980001097020053500000008046000007782609014,365241789128397645479568132213754896654983271897126453531472968946815327782639514,0.38654320000205189,42,14806,14764
007002069100307000008000030401289006600034701590076020700603005000940600930050410,347812569159367248268495137471289356682534791593176824714623985825941673936758412,0.03370730002643541,44,609,565
300467009400009003500000470185006904290000700007910035720504008934020000056090040,312467589478159263569283471185376924293845716647912835721534698934628157856791342,0.05174279998755082,43,1333,1290
300126085108409003200050140010004809480701200005080010000000008830240700974800060,347126985158479623269358147612534879483791256795682314521967438836245791974813562,0.02968350000446662,43,471,428
408007359100005700050090140001000062580000400604072030000008004920040607846050010,468217359139465728257893146371584962582936471694172835713628594925341687846759213,0.30692139995517209,45,11261,11216
207038061100009402300120050000056829680400300003080040700002003920840600036000090,247538961158679432369124758471356829682491375593287146714962583925843617836715294,0.02440749999368563,44,260,216
201007689360100402000280153005000006730502804004060020000800007600900300890071045,251347689368159472479286153125498736736512894984763521512834967647925318893671245,0.13063339999644086,43,4368,4325
107008359200700006450100000302004005500872600004010070000905208820000704946080530,167428359238759416459136827372694185591872643684513972713945268825361794946287531,0.05608379998011515,43,1538,1495
006057091100400002000000004002003057300701408000040130001930005930070210857010043,246357891173489562589126374412893657395761428768245139621934785934578216857612943,0.05058280000230297,45,1242,1197
005026479200009008000500100302000001504600207978010030000437805750800300840050710,185326479237149568496578123362784951514693287978215634621437895759861342843952716,0.02898669999558479,43,444,401
056010030100009076000500200400005002502600780637020010703050064900700008860090320,256417839148239576379586241481375692592641783637928415713852964924763158865194327,0.03936070000054315,45,882,837
057060040300417569460300000003000000670000100095026000002070984700938001080042670,157269348328417569469385712213754896674893125895126437532671984746938251981542673,0.03486129996599630,44,642,598
307096048200107306000000501106000059580020000704060020601050004800619005970083610,317596248258147396469238571126374859583921467794865123631752984842619735975483612,0.02564429998164997,42,273,231
154030086000100009379400001001020605007600048690800000042000060700900503900760010,154239786268175439379486251481327695527691348693854172842513967716948523935762814,0.04060270002810284,46,803,757
054060010108009073300100204001070382003521907790480000005002000900700008030000100,254367819168249573379158264541976382683521947792483651415832796926715438837694125,0.10941709997132421,46,3428,3382
416030590257109004300400002172080935003090001000010006900003070500800000760920450,416238597257169384389457162172684935643795821895312746921543678534876219768921453,0.04563110001618043,43,1067,1024
240060170108000024570100603000040000006917005490800206000090057750000001084700360,243568179168379524579124683315246798826917435497835216631492857752683941984751362,0.16563869995297864,45,5701,5656
240069030000070059300400006710000890003000204900500370401050082580090043602830500,245169738168372459379485126714623895853917264926548371431756982587291643692834517,0.02704999997513369,44,380,336
016370580358000002470200601120050970007892004800700200000000020930008007700600403,216374589358169742479285631123456978567892314894713256641937825932548167785621493,0.03540839999914169,44,684,640
048050109079300005256700034700020500002100003590600000014000080805000006900800251,348256179179348625256719834761423598482195763593687412614532987825971346937864251,0.15407749998848885,46,5463,5417
040050900100049067209308001410007600503090004800403200600035049000000036905760802,347156928158249367269378451412587693573692184896413275621835749784921536935764812,0.06945100001757964,43,1987,1944
062370409358040000400506208090030840003087002780600500001000080905000001807900325,162378459358249176479516238296135847513487692784692513621753984935824761847961325,0.04405739996582270,43,1080,1037
063050408005103096208400003010540700007090002900702000020000847700000005809600321,163259478475183296298467153312546789547398612986712534621935847734821965859674321,0.08011549996444955,45,2370,2325
140250839058070000300408005010000090000004027000620400820005964004001002906800103,147256839258379641369418275412587396683194527795623418821735964534961782976842153,0.05419759999495000,45,1429,1384
160040830380169045402503006016000900008001024740800300020090013000030008603700402,165247839387169245492583176216354987538971624749826351824695713971432568653718492,0.07532730000093579,42,2251,2209
040350800350060007200008005410630509000094060806512304620000700000000002705126403,147359826358261947269478135412637589573894261896512374621943758934785612785126493,0.10363720002351329,43,3405,3362
040100706210060985009008003100600597495032010700500402630000800050040060804006009,348159726217463985569278143123684597495732618786591432631925874952847361874316259,0.07100599998375401,43,2029,1986
340206180150070020260008047510000000006037012703800065620000300000000001805043206,347256189158479623269318547512694738486537912793821465621985374934762851875143296,0.23417110001901165,44,8644,8600
210450609060070058507003004300080400002097815800600002100000000004020081900041203,213458679469172358587963124371285496642397815895614732126839547734526981958741263,0.08316209999611601,45,2556,2511
107280005000040060200007000470390600000001039003600004620000940734010080895704103,147286395358149762269537418472398651586471239913625874621853947734912586895764123,0.09998649999033660,45,3284,3239
257139006000060000309004105120450907506007030000300001000200000040080063805003402,257139846418562379369874125123456987586917234794328651631245798942781563875693412,0.08472690003691241,46,2588,2542
147006023050000706009000015602305008080710600095004030500900004004020080876003091,147586923258139746369247815612395478483712659795864132521978364934621587876453291,0.03209970000898466,44,587,543
352470009000090540409008001210357800003010072007804003720000900035040060800009205,352471689168293547479568321214357896583916472697824153721685934935142768846739215,0.08271099999547005,43,2560,2517
237100589150290060009000302300700000600030070795002003520600007070010820800027001,237146589158293764469578312312754698684931275795862143521689437973415826846327951,0.25772669998696074,44,9414,9370
103208009260000385008090000300402006520010803007000014700506900030049021906001037,153268479269174385478395162391482756524617893687953214712536948835749621946821537,0.03880629997001961,43,818,775
251000008060007200408000100100060902582030761607001050800400000700090013906513807,251349678369187245478256139134765982582934761697821354813472596725698413946513827,0.03728069999488071,43,758,715
100400893350000700009000025200500008070090406605000031500940680980050000700812049,127465893358129764469378125241536978873291456695784231512943687984657312736812549,0.04262219998054206,45,933,888
140508027000000009000029048413000002570094806906007003600803904030060000005402001,149538627258746139367129548413685792572394816986217453621853974734961285895472361,0.03164099995046854,45,506,461
247105068380070000009030047400000009070000500098000001810307006734650002065002473,247195368381476295659238147423561789176983524598724631812347956734659812965812473,0.10808099998394027,43,3292,3249
216009504058002009009060012102000705080000100007005003700600008043050000905021037,216379584358142679479568312132486795584793126697215843721634958843957261965821437,0.07190759998047724,46,1958,1912
300109802008000000000040060600007028700600900503800607420900703000081040067032591,346159872158276439279348165614597328782613954593824617421965783935781246867432591,0.04111570003442466,46,875,829
137508009280009500600023087306080094470306100008007002800904006740060000005000041,137548269284679513659123487316285794472396158598417632821954376743861925965732841,0.04334299999754876,43,1003,960
147063059300501406050470100003045087700912300090007000001004600030000705000059230,147263859328591476659478123213645987785912364496837512571324698932186745864759231,0.03414169995812699,43,562,519
147030096268004007030080402325000068000000903000000004003000005750000049080056321,147235896268194537539687412325479168476821953891563274613942785752318649984756321,2.69119969999883324,46,99996,99950
508016094100209006460080200004008009280000301006005408001000005850400107070650040,528316794137249586469587213314728659285964371796135428641872935852493167973651842,0.17418370000086725,45,3430,3385
065037049400209003080450200003098002700310900090025030500903084930800700000060090,265137849471289563389456217153698472728314956694725138512973684936841725847562391,0.21286079997662455,44,3628,3584
207050068108009004360040100402003097500104823000000401000006009600900702080470310,247351968158769234369248175412583697576194823893627451721836549634915782985472316,0.07567160000326112,44,886,842
146005097200009603380060500403072089500608400090010006005003904920700008030040070,146235897257189643389467521463572189571698432892314756715823964924756318638941275,0.06737449998036027,43,838,795
216475093300269007470030200002007086500600700600004350000000008820510000930080010,216475893358269147479138265142357986583691724697824351761942538824513679935786412,0.17968170001404360,44,4129,4085
147003086300001702060580400001605029600700305000000001700000238920300104000040950,147293586358461792269587413471635829682719345593824671714956238925378164836142957,0.06600689998595044,45,1090,1045
200305098300006004460170300002009006500200809080060721000704003700801205090630010,217345698358926174469178352172489536536217849984563721621754983743891265895632417,0.05203289998462424,44,1085,1041
040050069208001004060740100402030098900100502000020017001004053590200806800970021,147358269258691734369742185412537698973186542685429317721864953594213876836975421,0.05915699998149648,43,1066,1023
240351089100209003080070100008007024400190506000600010500002007900710845804060030,246351789157289463389476152618537924423198576795624318531842697962713845874965231,0.06316729995887727,43,1069,1026
053407029200058007070030006014000002600900403080020000001002070700800605860710034,153467829296158347478239156314586792625971483987324561531642978742893615869715234,0.02264419995481148,46,121,75
120340970007090040400207008040970800500003017000602009010030000906001584200804301,128346975357198246469257138641975823592483617783612459814539762936721584275864391,0.09434419998433441,44,2526,2482
316000470402080030500300002130000000007000000894500007620930004700002053903408601,316259478472186539589347162135724896267891345894563217621935784748612953953478621,0.30227529996773228,46,9818,9772
100230908008060030300815006410370500805090060960020104020003095000001607700650410,146237958258469731397815246412376589875194362963528174621743895534981627789652413,0.03146069997455925,42,426,384
246350790007090380308100005460070809002009040900000007610000070705004012829706003,246358791157692384398147265461275839572839146983461527614523978735984612829716453,0.03346159995999187,42,482,440
290400300000560090308279000010080900625004080809000005460000070502001006980706401,296418357147563298358279614714385962625194783839627145461832579572941836983756421,0.06260699999984354,45,1584,1539
200300409008029050409508026310600008600050032700000001070000004803040005540712003,257361489168429357439578126312694578684157932795283641971835264823946715546712893,0.24739149998640642,45,8764,8719
100450709068097030509803064730000090000080010800000002010530608000064001206918503,123456789468197235579823164731245896652389417894671352917532648385764921246918573,0.07461769995279610,43,2151,2108
200308609060149080300007005430080700001402030900713002020030000009025006853601904,214358679567149283398267145432586791671492538985713462126934857749825316853671924,0.03119410004001111,42,544,502
230600509006080230009005186090800000000090063700000001010000908025010074947568302,238671549156489237479235186391846725582197463764352891613724958825913674947568312,0.17219729995122179,44,5703,5659
270140908016090040409000006000905802007000060600703004060500400002000081703809625,275146938316298547489357216134965872527481369698723154861572493952634781743819625,0.09346720000030473,45,2878,2833
240371500100040070309000001400780906003000000500106002821000700064000015705604208,246371589158249673379568421412785936683492157597136842821953764964827315735614298,0.29444540000986308,45,10154,10109
160205009270060580009000006300400008000090700790003002820000947030000065607904203,168245379273169584549378126312457698485692731796813452821536947934721865657984213,0.43711990001611412,46,15698,15652
340170600070090020209300007500780903094060000803005204420000800038000051651009702,345172689176498325289356147512784963794263518863915274427531896938627451651849732,0.07699460000731051,43,2106,2063
130260500250070000409508073310607804070020000800005002920000600003000025685002107,137264589258379461469518273312697854574821396896435712921753648743186925685942137,0.11433299997588620,44,3716,3672
240130509050060020109007040502800601000010782800002004000000805730000016905001073,247138569358469127169257348572894631493516782816372954621743895734985216985621473,0.11423969996394590,45,3435,3390
237500109008760040409000005300250008690084030500007006710020900000071023020003701,237548169158769342469312875371256498692184537584937216713625984945871623826493751,0.03492329997243360,44,574,530
106370900200190300309206050510600703800050010900004005420030500008000071700001832,146375928257198346389246157514682793872953614963714285421837569638529471795461832,0.10453630000120029,44,3208,3164
150200406439080000008000000300008009006097241790461005000840600200005018805003904,157239486439186572628754193341528769586397241792461835913842657264975318875613924,0.03186719998484477,44,488,444
200450809000260700000008105310500007000090000704003006920700608640900070805612093,237451869158269734469378125312546987586197342794823516921734658643985271875612493,0.10875820001820102,45,3330,3285
154260700060040805000007040400006008000080300986003012610800207030020081042001053,154268739367149825298357146423516978571982364986473512615834297739625481842791653,0.16394960001343861,44,5509,5465
130400208400300100000001037300004509080090060604005002910700005020006800806053971,137469258458372196269581437371624589582197364694835712913748625725916843846253971,0.02167580003151670,45,140,95
400900368360140907000000045100003006650000470007006032500600000002031650906704213,415927368368145927279368145124573896653289471897416532531692784742831659986754213,0.46507879998534918,43,16704,16661
240301009150090304000050070601000008480000050093002017906800005734520000805719043,247361589158297364369458172671945238482173956593682417916834725734526891825719643,0.02386880002450198,42,208,166
205607309160035200000000060400000008090180007003094012500709803820040500936052041,245617389168935274379428165451276938692183457783594612514769823827341596936852741,0.02750590001232922,42,358,316
200156809100409000060030051300907005574200600000805037700580900000604003006070582,237156849158429376469738251381967425574213698692845137713582964825694713946371582,0.15557850000914186,43,5043,5000
325008179160200400009000030800005004530690820006004051600970000048010060903046012,325468179167239485489157236871325694534691827296784351612973548748512963953846712,0.03427430003648624,42,588,546
400728003130009276000000085310000009082000500007064012500000900743900008806540700,465728193138459276279136485314275869682391547957864312521687934743912658896543721,0.09247740003047511,45,2813,2768
102308009350070140790004050400000807560080090907000001200900706030010020609005014,142358679356279148798164253421596837563781492987432561215943786834617925679825314,0.04056480003055185,45,889,844
306209801120400500000050030203000005074090308905360004701908006060000903009035012,356279841127483569498156237213847695674591328985362174731928456562714983849635712,0.02334329998120666,43,214,171
107589042200400109000030050070001006000090200602070013800900407020040090006013025,137589642258467139469132758374251986581396274692874513813925467725648391946713825,0.44871909997891635,46,15231,15185
402761309300209407000340260200030078800900001507000032000000004040015706005002093,452761389368259417179348265214536978836927541597184632721693854943815726685472193,1.50154839997412637,44,36188,36144
107459082200100409009080030500028064380500207602300010003700006720090003006000020,137459682258163479469287135571928364384516297692374518813742956725691843946835721,0.24037110002245754,44,8067,8023
465000092100200300080060075300507009000890204008000037590400703720900800006050041,465378192179245368283169475342517689657893214918624537591486723724931856836752941,0.02021280000917614,45,61,16
106047093307109200400060500010002009620010475009086021800704006070000130065000042,156247893387159264492368517513472689628913475749586321831724956274695138965831742,0.02968450001208112,42,407,365
137048069200600013009070084305002007000506000800000050601804005750000000004065321,137248569248659713569173284315482697472596138896317452621834975753921846984765321,0.08538800000678748,45,2513,2468
105234089308100000470060000200456078600000000090300015500603007730000001006010042,165234789328197456479568123213456978657981234894372615541623897732849561986715342,0.55708499997854233,46,20422,20376
027050069408100003060040108203005007070800904000020030601002005740500300085030710,127358469458169273369247158213495687576813924894726531631972845742581396985634712,0.02823310001986101,45,415,370
316009028209100407000050300501007084090004706060090000000005009640900800087043150,316479528259138467478256391521367984893524716764891235132785649645912873987643152,0.07507570000598207,45,2183,2138
108004070300500008070010200206409007040001906007060410600003025000650300835042060,158234679362597148479816253216489537543721986987365412694173825721658394835942761,0.21438089996809140,45,7564,7519
154000986268100007079080250401309075000600803630010000700002009800000700020040030,154237986268195347379486251481329675592674813637518492743852169815963724926741538,0.06258450000314042,45,1654,1609
206074050300000006480020070620908540105063200090052630000005082040000700568090310,216374859357189426489526173623918547175463298894752631731645982942831765568297314,0.03013349999673665,43,442,399
107068092208000107430070500002004059500002006000030000000803975900500600740026810,157368492268459137439271568312684759574192386896735241621843975983517624745926813,0.03557489998638630,45,693,648
058000697400002005000000102024005069380007501090020030700003906940500200065010073,258134697471962385639758142124385769386497521597621834712843956943576218865219473,0.07085720001487061,45,2038,1993
205000019100009007300040500003002076590407003021063000000004758900700620057021934,245376819168259347379148562483592176596417283721863495612934758934785621857621934,0.04327900003409013,43,984,941
041050760500069003009400500006090070200000005050000300003806954920730100865041230,341258769572169843689473521136592478297384615458617392713826954924735186865941237,0.02296830003615469,44,174,130
158030090409107003273400000000070080500902001690000500005001039800600700946050810,158236497469187253273495168312574986584962371697318524725841639831629745946753812,0.02609060000395402,45,289,244
056010040170009006000400102002080097760105008900000600001006074600900205849050361,256318749174529836398467152412683597763195428985274613521836974637941285849752361,0.04496620001737028,44,990,946
105360090200009005080200006003090080701408003090010500007004038900500407634070259,145367892276189345389245176453692781761458923892713564517924638928536417634871259,0.02717869996558875,44,296,252
045061080108009005370200000012040090700603002800010600001006073900100804586030920,245361789168479235379258416612547398794683152853912647421896573937125864586734921,0.02450360002694651,44,184,140
207040060008309057400600002000060080500803001890010600001004735900700800085036190,237145968168329457459678312312467589576893241894512673621984735943751826785236194,0.12916660000337288,45,3908,3863
038040070509007008100500306012050090400901002090080405001002083700800000846030251,238146579569327148174598326312654897485971632697283415951462783723815964846739251,0.09877939999569207,44,2846,2802
058340070209008045400200006010890050507000038980500102002005091600700000740080600,158346279269178345473259816316892457527614938984537162832465791691723584745981623,0.03614069998729974,45,627,582
138057060002008003000304100001080090200906004090040802003005046900600007850070231,138257469462198753579364128341782695285916374697543812713825946924631587856479231,0.03371769998921081,45,543,498
126048750308009006409500300040080090500007063000000200007004035900700002865030401,126348759358279146479516328642183597591427863783695214217864935934751682865932471,0.10240810003597289,45,2917,2872
157240098368107005400300007013080000500001004890000000001060089940000501680400703,157246398368197245429358617213784956576921834894635172731562489942873561685419723,0.02198039996437728,44,60,16
207060039050003046300408000070032900600004075490000208014020007905007003706500492,247165839158293746369478521571832964682914375493756218814329657925647183736581492,0.05501509999157861,43,1152,1109
137040589208130060400507003000070600000001008790000000003052004904703806870960301,137246589258139467469587213381475692542691738796328145613852974924713856875964321,0.02689909999025986,43,235,192
137050480200030060500407001400070800006008014900620705003040072702903008800000103,137256489248139567569487321425371896376598214981624735613845972752913648894762153,0.08067420002771541,44,2166,2122
247056080100009060300187400000060800005008003890700500001073048603402001900005206,247356189158249367369187425732561894415928673896734512521673948683492751974815236,0.02459999994607642,44,115,71
457310620000005040100247000070080500000001076090000802002034005905102084800709200,457318629328695147169247358271486593583921476694573812712834965935162784846759231,0.27690270001767203,45,9498,9453
240061870100009042300200600050670020700004006000000714517026083608400007900708200,245361879176859342389247651451673928792184536863592714517926483628435197934718265,0.05023510003229603,43,1257,1214
215040780400007320309200005080020000002501008000800602001082003926004001807900200,215349786468157329379268145183426597692571438754893612541682973926734851837915264,0.05947449995437637,45,1541,1496
130428560200069030400307008010000000700001005090600204001000053502904601900510740,137428569258169437469357128314295876726841395895673214641782953572934681983516742,0.06132229999639094,44,1583,1539
138050970260008030400200006040060000002091003000300001010007004927005008604810720,138456972269178435475239186341562897582791643796384251813927564927645318654813729,0.25392240000655875,46,9113,9067
130480250200090040460205008010000005500021063000308104000009032903014006640702801,137486259258193647469275318312647985584921763796358124871569432923814576645732891,0.05253670003730804,42,1341,1299
130250680208000040400600007320040800001096004600002703070010900003005472940807500,137254689268179345459638127325741896781396254694582713572413968813965472946827531,0.10865329997614026,44,3551,3507
210300500000000040400170006720091604065000719100706803030080400008002075600504901,216348597357269148489175236723891654865423719194756823531987462948612375672534981,0.04294000001391396,44,1008,964
217060300400039000300002005020007500004010732790306014531600900042800003800203000,217568349458139267369742185123487596684915732795326814531674928942851673876293451,0.17354500002693385,44,6091,6047
150200708008000000309508002410300870007000023600402001060000004924005037830746009,156234798248197365379568142412359876597681423683472951761923584924815637835746219,0.49150559998815879,44,18836,18792
230140605108060000400207003014870000602003018900600302020030009806001007790405260,237148695158369724469257183314872956672593418985614372521736849846921537793485261,0.03174639999633655,42,547,505
200560390108370020300004001070090004402000057600400012810020065025000003730805009,247561398158379426369284571571692834492138657683457912814923765925746183736815249,0.03242060000775382,44,585,541
320001580100069040400500006540000800003000465690805031710030954064000008800104002,326471589158269743479583126541326897283917465697845231712638954964752318835194672,0.14244770002551377,43,4829,4786
140270380000054000300006045480007009001060834600940012010020008026000003807405001,145279386268354197379816245482137569791562834653948712514623978926781453837495621,0.31692170002497733,44,11660,11616
306109400200400090400085600060300900503017000704008001820500700037042019905700860,356179428278463195419285673162354987583917246794628351821596734637842519945731862,0.07576179999159649,43,2345,2302
120954000008073050500206004390000000004010035600307902710030690806000003950860041,127954386468173259539286174391528467274619835685347912712435698846791523953862741,0.11732240003766492,43,3877,3834
357400108160200900200008350410300069000000080800004003620040700004051030705906804,357469128168235947249178356412387569573692481896514273621843795984751632735926814,0.02542700001504272,44,290,246
250100093310000400400008002020600500794020010500001004630080709042003001905400208,257164893318297465469358172123649587794825316586731924631582749842973651975416238,0.13694159995066002,45,4531,4486
156300209020050060308006054500080003080010046000005701030020890842000035900000012,156348279427159368398276154514687923783912546269435781631524897842791635975863412,0.08547890000045300,45,2497,2452
100250039250009070300007054510003402070010680000405007020508703034000008700030921,147256839258349176369187254516873492473912685892465317621598743934721568785634921,0.08242609997978434,43,2288,2245
200357009600000208049000000400010000080426001100803004700600902024030070965742813,218357469657194238349268157472519386583426791196873524731685942824931675965742813,0.04450380004709587,43,937,894
200389406069020018408007020100008004590070000004001003020040900005016240906702801,217389456369425718458167329172538694593674182684291573721843965835916247946752831,0.11487910000141710,43,3782,3739
100438509208009000009000800400512000580090000002004003800007200005041030906025714,167438529248159367359276841473512986581693472692784153814367295725941638936825714,0.95800440001767129,46,37340,37294
100268059200300000400071030300002905590080760804009001700400603023000040905830207,137268459258394176469571832316742985592183764874659321781425693623917548945836217,0.05636799999047071,43,1549,1506
530107409064000080200400030300005906420090050805004003000930805002076010003501692,538127469164359287279468531317285946426793158895614723641932875952876314783541692,0.05399869999382645,43,1387,1344
106208000040190000309060018400706809580000670007005001810400900024070085705000342,156238794248197536379564218431726859582941673697385421813452967924673185765819342,0.07557650003582239,43,2326,2283
140207008058060000300000060500302609490070010703001025600080200905010080837605941,146237598258169734379458162581342679492576813763891425614983257925714386837625941,0.02424319996498525,42,257,215
304628009100009800009000600500306000010290706006004035400003508035080017708500362,354628179167459823289137654542376981813295746976814235421763598635982417798541362,0.04867619997821748,43,1152,1109
205407098060230400079080021302004000690000140004001006520700800043060019006000273,235417698168239457479586321312674985697358142854921736521793864743862519986145273,0.04872749996138737,43,1106,1063
205109007100307504000080310300002000680900705004000061506203478900070050007001923,235149687168327594479586312351762849682914735794835261516293478923478156847651923,0.03376239998033270,43,518,475
247503019108200006060070002400002008580000030003007021900600007725090063006000045,247563819158249376369178452471352698582916734693487521914635287725894163836721945,0.03972469997825101,45,565,520
207409068100360709060080000305000006720630890806000032940800007002000900003005014,237419568158362749469587321315298476724631895896754132941823657572146983683975214,0.03662189998431131,45,700,655
759104002100300609000050000203407006460000000007003428600705004900020760075046013,759164832142378659386259147213487596468592371597613428621735984934821765875946213,0.28596790001029149,44,9976,9932
456203001107400203020090000201009007980070400004000039600700045709050020045020076,456283791197465283328197564261349857983576412574812639612738945739654128845921376,0.03544299997156486,44,620,576
207050089140200305080090002000004008470980200000007061500600007720000900968000514,237451689149268375685793142356124798471986253892537461513649827724815936968372514,0.08639360003871843,46,2530,2484
247006085100409600000070020000007008680010400003005210800903701500260009034081060,247136985158429673369578124412697358685312497793845216826953741571264839934781562,0.03802370000630617,45,652,607
217406009400109700000070000005607008180000203004003010600802307850700004073060182,217456839438129765569378421325617948186945273794283516641892357852731694973564182,0.18239639996318147,44,6115,6071
237000085158200900009050000500006002380020060000005014700900406920010300846003290,237149685158267943469358127571496832384721569692835714713982456925614378846573291,0.04275100002996624,45,908,863
148209065207300409000040010501603004420050900703000150800905007630000500000010023,148279365257361489369548712581693274426157938793824156812935647634782591975416823,0.05219920002855361,44,1196,1152
105068047700401002240057610017039086002004105000000004000805073850900401000010020,195268347736491852248357619417539286362784195589126734621845973853972461974613528,0.04881529998965561,43,1085,1042
327100089100209006000070020200007004000904302004000761901005048870400905045090010,327146589158239476469578123213657894786914352594382761931725648872461935645893217,0.11303489998681471,44,3449,3405
207010089100509003050020140002065008000008302080070005001806907760900820000032651,237614589146589273958327146312465798475198362689273415521846937763951824894732651,0.03665709996130317,43,582,539
403058096100309008080060130004036085390502407060000001600905002940600700000023019,473158296126349578589267134214736985398512467765894321631975842942681753857423619,0.02222240000264719,42,122,80
201009687300100009000060010103046098480200300007000004900604005850720900000035042,241359687368172459579468213123546798485297361697813524932684175854721936716935842,0.04775269998935983,45,1004,959
317006089500109604060070000104002008200300400090080021001823005950600800003050216,317246589528139674469578132134762958285391467796485321641823795952617843873954216,0.11777979996986687,43,3645,3602
346109078100200009098060000603700004700500860085003002000802096530000400800070021,346159278157284639298367145613728954724591863985643712471832596532916487869475321,0.06791340000927448,45,1679,1634
302400719100203008080150002007000006634700090005010000001024003920000800700039520,352468719176293458489157632217945386634782195895316247561824973923571864748639521,0.16552169999340549,46,5263,5217
345210709000009000270040063400620097006000200790004000800950006007400832604083001,345216789168379524279548163481625397536197248792834615813952476957461832624783951,0.34382080001523718,44,11686,11642
125348607300000000090200050200010809004000300850003001500890002002500906903026008,125348697376159284498267153237415869614982375859673421561894732782531946943726518,0.29905829997733235,46,10094,10048
145367209000009000070050063700590046002000900690014002500920007006700504807035001,145367289368249175279158463781592346452673918693814752514926837936781524827435691,0.11231649998808280,43,3141,3098
305400789260089000400050061106000890890070506570008000630000004700000052052006300,315462789267189435489357261126534897893271546574698123631825974748913652952746318,0.16320299997460097,45,5047,5002
315248609000070000089000020100020803003004000890013002500460087008700206602085001,315248679426179538789356124154627893263894715897513462531462987948731256672985341,0.97249889996601269,44,35231,35187
356248709200000000080000050400020078028000100790013004500690041001500207802031005,356248719274159386189367452413926578628475193795813624537692841961584237842731965,0.09408730000723153,44,2697,2653
017460392208130067069000800120080006700090000050301008601040009090003005870016004,517468392248139567369257841123784956784695123956321478631542789492873615875916234,0.11891650001052767,43,3943,3900
100540092050000030209000405600093000000007008500810064021900603803005009965021807,136548792458279136279136485682493571314657928597812364721984653843765219965321847,0.07055140001466498,44,2095,2051
307190064010000070209000105100000000000007002804630009030700406740009001986041327,357198264418256973269473185175924638693817542824635719531782496742369851986541327,0.17273869999917224,45,5937,5892
200430089060000040409000301100370000000004002800060007010003900940718006785692413,251437689368129745479856321126375894537984162894261537612543978943718256785692413,0.29850249999435619,44,10825,10781
200430089060000040409000301100370000000004002800060007010003900940718006785692413,251437689368129745479856321126375894537984162894261537612543978943718256785692413,0.25406379997730255,44,8977,8933
200460078076000050409000002100090000000001004500030607060003800810026005945718236,251469378376182459489375162124697583637851924598234617762543891813926745945718236,0.18438180000521243,45,6436,6391
300760082068200050209000006500070000000805003700090001010006200920037005837521964,354769182168243759279158346541372698692815473783694521415986237926437815837521964,0.11745870002778247,44,3773,3729
008007369000000208025009700210073805400590031090800400000008006750640003860035027,148257369379164258625389714216473895487592631593816472931728546752641983864935127,0.03203760000178590,43,494,451
008000914100000703073009600340072005500930076090500200000003007926010008730046029,258367914169428753473159682341672895582931476697584231814293567926715348735846129,0.03120219998527318,44,490,446
008300014000400703073009000340070005500901076007500200004003500920010008730846029,258367914169428753473159682341672895582931476697584231814293567926715348735846129,0.08474919997388497,45,2435,2390
100260089058000460300000005500000006000703012002010503020007600430028007976541238,147265389258379461369184725513492876684753912792816543821937654435628197976541238,0.04334229999221861,43,844,801
007008569001000208089006300350087006100690035090500700000004003920860007640735021,237148569461359278589276314352487196174692835896513742715924683923861457648735921,0.07714340003440157,42,1820,1778
400360027069000840500000009300007000080006035000020781030004900840091002957832614,418369527269175843573248169321587496784916235695423781132654978846791352957832614,0.04773839999688789,43,1095,1052
100006047009500328273009100310092004507040003000300090000008405740050000980174032,158236947469517328273489156316792584597841263824365791631928475742653819985174632,0.05326329998206347,43,1325,1282
201000078306100450489005100100097083000800024000000610700003800810026005940718036,251469378376182459489375162124697583637851924598234617762543891813926745945718236,0.04287370003294200,42,829,787
200000658008100490460000700500001004600450037000830520003005100840013009170289045,217394658358167492469528713532971864681452937794836521923745186845613279176289345,0.05260200001066551,43,1172,1129
100000925008409360360000100400008006500690013000700850004003600920067001730142089,147386925258419367369275148471538296582694713693721854814953672925867431736142589,0.04668069997569546,43,1041,998
300000816008400390560000700200008007400320058000700120000005200730014009950872031,347259816128467395569183742213598467476321958895746123681935274732614589954872631,0.08040440001059324,45,2248,2203
300000816008400390560000700200008007400320058000700120000005200730014009950872031,347259816128467395569183742213598467476321958895746123681935274732614589954872631,0.25363380002090707,45,8433,8388
100320096000100080009000105503004900420073001000210438002006800050002000964031207,145328796276159384389467125513684972428973561697215438732546819851792643964831257,0.26425920001929626,45,9138,9093
300490078000300090009000106203004500680059003000830614001005900040006000965013802,356491278128367495479528136213674589684159723597832614831245967742986351965713842,0.04679059999762103,45,1034,989
400230069000100040000000201105002400290056003300490825001004900040005000856023704,418237569529168347673549281185372496294856173367491825731684952942715638856923714,0.14910740003688261,45,4499,4454
150248069008160457409000200070005000500010006000800035002000800935001000840720091,157248369328169457469357218271635984583914726694872135712596843935481672846723591,0.04451559996232390,45,986,941
300490078100300090009000136203004500680059003000830614001005900040006000965013802,356491278128367495479528136213674589684159723597832614831245967742986351965713842,0.08017779997317120,43,2135,2092
150936048002100597409000300010004000700080002000310076001400700973005600840760023,157936248362148597489257361216574839734689152598312476621493785973825614845761923,0.04230800003279001,43,844,801
230458096108000047409000000070206000600090001000370082003700800725003400840900023,237458196158639247469127538371286954682594371594371682913742865725863419846915723,0.16139969998039305,45,5135,5090
340125089007000026209400000060003000800010003000580071005700900928001300730800612,346125789157398426289467135561273894872914563493586271615732948928641357734859612,0.02860270004021004,45,322,277
250163079009050021401200000020006000700090006000510032003700600947001250682900317,258163479369457821471289563124376985735892146896514732513728694947631258682945317,0.12881909997668117,42,4002,3960
150349076009000035203000000012007000500090003000280041001900600735001400946800312,158349276469712835273568194312457968584196723697283541821934657735621489946875312,0.35174690000712872,44,12189,12145
450136098100000047200800000001002000580060004000780021005600900923000400846300750,457136298138295647269847135371452869582961374694783521715624983923578416846319752,0.08196179999504238,46,2221,2175
360140059400000078000200310106002800280091003700860042001900407040000000857004900,368147259412359678579286314136472895284591763795863142621935487943718526857624931,0.46814690000610426,45,16446,16401
230458091100000048409300020061004900570031004800000032008000470023009800945000203,236458791157692348489317526361284957572931684894765132618523479723149865945876213,0.21422339999116957,43,6882,6839
340510892100039007000400030001005900580064003700120046004700089007000601835001200,346517892158239467279486135461375928582964713793128546614752389927843651835691274,0.02020020002964884,43,53,10
130467298200089001000100060001006800372091400900500030000700005000000613059003700,135467298267389541498125367541236879372891456986574132613742985724958613859613724,0.07506790000479668,46,2003,1957
260458379300069008400200050006004700530086000700500020000800004007940502024005800,261458379375169248489237156196324785532786491748591623653872914817943562924615837,0.20722119999118149,45,6964,6919
210347089300089006400250030001602700670094000980500020000900005005010900039005400,216347589357189246498256137541632798672894351983571624164923875725418963839765412,0.09566639998229221,45,2830,2785
210368094400029006300450020002805400580046000600700080000670003006000207045003600,217368594458129736369457821172835469583946172694712385821674953936581247745293618,0.25247829995350912,45,8945,8900
350641089160079005400380060004803500590017000700902010000500008007020406045006200,352641789168279345479385162214863597596417823783952614621534978937128456845796231,0.02988659997936338,43,441,398
140238096200096007300450082002803900580042000600501020000600009005000608036009450,147238596258196347369457182472863915581942763693571824714685239925314678836729451,0.12011200003325939,43,3971,3928
546038297100740056000500480203007800480001000690000504000000945002800670760095100,546138297128749356379526481213457869485961732697283514831672945952814673764395128,0.05115720001049340,42,1286,1244
154078269200150084000400750403005800670001000890000002500040970006800520730092100,154378269267159384389426751413265897672981435895734612521643978946817523738592146,0.02388049999717623,42,224,182
154078269200150084000400750403005800670001000890000002500040970006800520730092100,154378269267159384389426751413265897672981435895734612521643978946817523738592146,0.02254249999532476,42,190,148
451037608600150043000400070507000400160002500290000006700020060005800730840013900,451237698679158243382469175537681429164392587298574316713925864925846731846713952,0.12818119995063171,45,4421,4376
241036709300190054000270063405000600120003000790000005600080040053700820870029000,241536789367198254589274163435817692126953478798462315612385947953741826874629531,0.06175319995963946,44,1701,1657
345017609100380045000400017401000800760008000900050002500830060024900530839046000,345217689176389245298465317451723896762198453983654172517832964624971538839546721,0.08024809998460114,43,2366,2323
137086209200190047000500038306000905720009000800070004500930080002700510670015400,137486259258193647469527138316248975724359861895671324541932786982764513673815492,0.05193479999434203,43,1345,1302
261048509300169028000200031102000700690007000700010003500890067006700850830026000,261348579375169428489275631142953786693487215758612943524891367916734852837526194,0.31197540002176538,43,11458,11415
256137849300040002400200530005003400600018000000400750001700026002000380060052000,256137849397845612418269537125973468674518293983426751531784926742691385869352174,0.11166689998935908,46,3518,3472
256137849300040002400200530000003400600018003000400750501780026002000380860052070,256137849397845612418269537125973468674518293983426751531784926742691385869352174,0.16523719998076558,42,5686,5644
256137849300040002400200530000003400600018003000400750501780026002000380860052070,256137849397845612418269537125973468674518293983426751531784926742691385869352174,0.19735969998873770,42,6923,6881
256137849300040002400200530000003400600018003000400750501780026002000380860052070,256137849397845612418269537125973468674518293983426751531784926742691385869352174,0.02113239996833727,42,117,75
260370058400100030509000107120507006380600004600810003002700860043000000756081002,261379458478125639539468127124537986387692514695814273912743865843256791756981342,0.02840300003299490,43,393,350
400350829200100050560008100100005008000800002786020001600000937052000080870064005,417356829238149756569278143124695378395817462786423591641582937952731684873964215,0.41961610002908856,46,15653,15607
200340067300100090400008105500704008000800006807020304000900540643001000985032001,251349867368157492479268135536714928124893756897625314712986543643571289985432671,0.19548589998157695,45,6944,6899
201340769300200004409100350120007006600090021000600830702080005030001070840025010,251348769367259184489176352128537496673894521594612837712983645935461278846725913,0.08867179998196661,43,2830,2787
100320098208100050300000102400603000000200001702080003010800970927016005834759016,145327698268194357379568142481673529693245781752981463516832974927416835834759216,0.20251049997750670,42,7186,7144
000100095107200360280000701500398006000600003803010007010800500720060004938754012,346187295157249368289536741571398426492675183863412957614823579725961834938754612,0.11323529999936000,43,3607,3564
200130589100200360360008000400020005000900072090070403600750948020001050780060031,247136589158297364369548127471823695536914872892675413613752948924381756785469231,0.16101809998508543,44,5348,5304
100240067403000900270000004300580006006400031704013008020800540830054000045700183,158249367463178925279365814312587496586492731794613258627831549831954672945726183,0.17222020000917837,43,5832,5789
200410089108300700460008021300100004000200015805090007020700690780061002046800173,237416589158329746469578321372185964694237815815694237521743698783961452946852173,0.02831799996783957,42,380,338
100360289300000100260008000400000006002900730093080002910450328820031070030800041,147365289358249167269178453471523896582916734693784512916457328824631975735892641,0.11670369998319075,44,3815,3771
100450792207100300480007000300040009000900031094010006920870653540091080060300014,136458792257169348489237165312546879675982431894713526921874653543691287768325914,0.05214519996661693,42,1325,1283
001500980270000506605100070420015009000200065039000700810034007900670048760852003,341567982278349516695128374426715839187293465539486721812934657953671248764852193,0.02550809999229386,42,277,235
100040079207003600400067003000600097062000300970081004000730986040005000080900451,136248579257193648498567123314652897862479315975381264521734986649815732783926451,0.06603509996784851,46,1821,1775
100040079207003600400067003000600097062000300970081004000730986040005000080900451,136248579257193648498567123314652897862479315975381264521734986649815732783926451,0.06703559996094555,46,1881,1835
100040079207003600400067003000600097062000300970081004000730986040005000080900451,136248579257193648498567123314652897862479315975381264521734986649815732783926451,0.07256590004544705,46,1996,1950
056309280470052009009400057310007000000000708907040000620900005003800692895006403,156379284478152369239468157312587946564291738987643521621934875743815692895726413,0.09465620003174990,43,2967,2924
250068094401000508300057021004500769036004000980010002000800947040901000070600153,257168394461329578398457621124583769736294815985716432612835947543971286879642153,0.04379909997805953,42,847,805
250068049308000205400002080002005608583001000690080003001900804035004000040800071,257168349368479215419532786172345698583691427694287153721956834835714962946823571,0.10981990001164377,45,3394,3349
057108390460029008008400021120003700030094005005010002610800040000000206879002103,257168394461329578398457621124583769736294815985716432612835947543971286879642153,0.02216210000915453,43,144,101
157308290260059007009200058370004900080002005502070001810900070000000503745006109,157368294268459317439217658371584962684192735592673841813925476926741583745836129,0.04221740004140884,42,887,845
208370950150008070003500028310005800080092003004080002820900000007006009946007201,268371954159428376473569128312645897785192643694783512821934765537216489946857231,0.25087789999088272,44,8825,8781
205196387100008059009400610431005800650000004008010003510700060024000705870009001,245196387167328459389457612431275896652983174798614523513742968924861735876539241,0.09488749998854473,42,2909,2867
268371954100008076003000120310005800780090003004000002820000060037000409946007001,268371954159428376473569128312645897785192643694783512821934765537216489946857231,0.07121610001195222,43,2055,2012
250067089108000275309008000000003008603080004840600010001000697036004802080726031,254167389168349275379258146512473968693581724847692513421835697736914852985726431,0.04532259999541566,42,1041,999
247358691100009073009000400430005000800690004006800020610000780024001906985006002,247358691158469273369127458431275869872693514596814327613942785724581936985736142,0.02469230000860989,42,267,225
108300429360000007000020136203700900680109200000800014520047600900000000047600090,158376429362491857479528136213754968684139275795862314521947683936285741847613592,0.05059379996964708,46,1293,1247
207400681148000000500000043305600100480300000000800074710008402900720006026500910,237459681148236795569187243375694128481372569692815374713968452954721836826543917,0.02847869996912777,45,343,298
106509284250004000400000071301000400570400000000600032610005807700000049049700360,136579284257184693498326571361297458572438916984651732613945827725863149849712365,0.03173369995784014,46,531,485
