Puzzle,Solution,Execution Time,Zeros,Guesses,Backtracks
207408609100090007000070000370602098600000001580719063800524006005060800906837102,237458619158296347469173285371642598694385721582719463813524976725961834946837152,0.01358010002877563,41,77,36
257000439300000006160000082400603005003912800090040010601537908000821000085090320,257168439348259176169374582412683795573912864896745213621537948934821657785496321,0.01321689999895170,42,52,10
000374089008100400470086003030000048507640391090000052820067005003900200000231074,216374589358129467479586123132795648587642391694813752821467935743958216965231874,0.01689899998018518,42,266,224
208369407600154003500278006004000800305080702780010045400000008052000630060843020,218369457679154283543278196124537869395486712786912345431625978852791634967843521,0.01348219998180866,41,64,23
468051739100000600000670012084030060315406007097080040000910074900000300753064291,468251739172349658539678412284137965315496827697582143826913574941725386753864291,0.01347619999432936,39,57,18
146000598207000304389000127400060002600872001002010900000643000060589040930020085,146237598257198364389456127413965872695872431872314956528643719761589243934721685,0.01306909997947514,41,49,8
147903268000000000309070105410060089603000401095080630000534000500692003030010020,147953268258146397369278145412365789683729451795481632821534976574692813936817524,0.01374189998023212,43,85,42
040096580000007009300208174010000948800000007934000060481605003600700000073140020,147396582258417639369258174716532948825964317934871265481625793692783451573149826,0.01366009999765083,45,80,35
307165209200394006000278000012000860803000402490080035600000008784000523030020040,347165289258394716169278354512439867873651492496782135621543978784916523935827641,0.01438680000137538,42,117,75
100238005200040006400679008002090600508020901690000052700000004835402179046010520,167238495289145736453679218312594687578326941694781352721953864835462179946817523,0.01382369996281341,41,99,58
100458002200109003009237100000684000600395008890010064021000730940000021760020085,136458972257169843489237156312684597674395218895712364521846739948573621763921485,0.01296339998953044,41,44,3
340080019100040002009107300000623000603794105790010036401000603935000278870000041,347286519158349762269157384514623897683794125792815436421978653935461278876532941,0.01697230001445860,40,299,259
125030489300109007000000000201070804700491006090080070512000748907000602860725013,125637489348159267679248135251376894783491526496582371512963748937814652864725913,0.01285729999653995,40,44,4
037140560108006004460570008010000290904007685080000430590730006601009003073650910,237148569158296374469573128316485297924317685785962431592731846641829753873654912,0.01294819999020547,39,56,17
030000208248100076069270003610380000000000000000092014900043860350007921806000030,137456298248139576569278143612384759493715682785692314921543867354867921876921435,0.01489779999246821,45,140,95
130200450000300008809070013460105000003080100000704032320040906600003000085009041,136298457247351698859476213462135879573982164918764532321547986694813725785629341,0.01353569998173043,46,79,33
107246500000010400000078020302400956080000070794005208020890000003050000005762801,137246589258319467469578123312487956586921374794635218621893745873154692945762831,0.01409659994533285,45,73,28
250160800160000702009008040400600908020080030905003001040700600702000014006014027,254167893168349752379258146413625978627981435985473261541732689732896514896514327,0.01359359995694831,46,78,32
147306002250100000300200145410508607005062800820703504500800769670900000984605001,147356982258149376369287145413598627795462813826713594531824769672931458984675231,0.01362719997996464,37,82,45
200347096360000000009802000410500907080090010703006048000903800000000079940685001,258347196364159782179862435412538967586794213793216548621973854835421679947685321,0.01349290000507608,46,69,23
347009028150000600200100435410685003005093800890417006700900584530000900986004012,347569128158342679269178435412685793675293841893417256721936584534821967986754312,0.01288420002674684,37,45,8
057208406400150070300060001210504000004000100000306049800020004040071003502603910,157238496468159372329467851213594687694782135785316249831925764946871523572643918,0.01587459997972474,45,204,159
006357928000000704300084005412500097083970050597800013700098006000000209004723581,146357928258619734379284165412536897683971452597842613725198346831465279964723581,0.01346699998248369,38,97,59
103207408460090037070030010300504009084912370090080040901653704800000001006000900,153267498468195237279438516312574869684912375597386142921653784835749621746821953,0.01292969996575266,42,54,12
206000308350000061190060027400503009002896100003070200600732004700010005839040712,246157398357289461198364527461523879572896143983471256615732984724918635839645712,0.01311199995689094,41,50,9
100098254408000000059400607300845000080000030000132008801009460000000705975360001,137698254468527319259413687312845976584976132796132548821759463643281795975364821,0.01486910000676289,45,126,81
207459601000000000069128470000296000050814020890070064600000008720080016980030042,237459681148367259569128473471296835356814927892573164613742598724985316985631742,0.01319440000224859,42,51,9
107254089392160400000070200200000070500802134900000020000030800635980700809627013,167254389392168457458379261213546978576892134984713625721435896635981742849627513,0.01475879998179153,41,147,106
100368009400259008080010050012080490504000802690724031900506003000000000046832910,157368249463259178289417356312685497574193862698724531921546783835971624746832915,0.01400470000226051,41,91,50
000629540200084600400005102070000039602000407380000050703800005005910004046253000,137629548259184673468375192571462839692538417384791256713846925825917364946253781,0.01383879996137694,45,78,33
007269030000540700350108006520000047674900385890000012410605009000890200005724060,147269538268543791359178426521386947674912385893457612412635879736891254985724163,0.01351849996717647,40,43,3
026154780108000304479080251200060008500709003090020040000070000000948000015030490,326154789158297364479386251231465978584719623697823145942571836763948512815632497,0.01407390000531450,44,80,36
246010097150200006309407105000040000470895061000020000501906803760300009938050072,246518397157239486389467125612743958473895261895621734521976843764382519938154672,0.01726709998911247,40,265,225
046030097002109008700000100060095073400802009590360010004000005900501300830040720,146238597352179468789654132261495873473812659598367214614723985927581346835946721,0.01317679998464882,45,55,10
002140860408250000170300004010000076605702341090000028520900007806570000007820630,352147869468259713179368254213485976685792341794613528521936487836574192947821635,0.01342509995447472,42,59,17
006280700207351009800400031010000096503008147070000023300700068704832005005140300,136289754247351689859467231412573896593628147678914523321795468764832915985146372,0.01398549997247756,41,50,9
007348900300169007400050003070030080503000704690000021920504038706801405045090170,217348956358169247469257813172436589583912764694785321921574638736821495845693172,0.01941529999021441,40,451,411
150347620000068005000200040412070060675009203983010070000800030000034006830926750,159347628247168395368295147412573869675489213983612574796851432521734986834926751,0.01844120002351701,41,352,311
017259640000060000500748003030080060805906702290000034000315000150090076004627300,317259648428163597569748123731482965845936712296571834672315489153894276984627351,0.01320019998820499,42,51,9
004167290000340500100008034080003006702000401900700080610500009003081000095674100,354167298268349517179258634581423976732896451946715382617532849423981765895674123,0.01356659998418763,45,80,35
100234007040000030308000401421060398580020064009000200002040500030516070960872043,196234857247158639358697421421765398583921764679483215712349586834516972965872143,0.01870339998276904,41,383,342
207108309300629007060307050012000690500080001800090004021030780734805926980000013,247158369358629147169347852412573698593486271876291534621934785734815926985762413,0.01313959999242797,39,52,13
100058963000009057039600200370400008482036095690700001013500800000003019800014372,147258963268349157539671284371495628482136795695782431913527846724863519856914372,0.01302890002261847,40,58,18
230050097070060050581409236100000005860295041700804003000080000007521800900746002,236158497479362158581479236124637985863295741795814623612983574347521869958746312,0.01368639996508136,41,64,23
200300489450000070009400005600200104092060830803001002900005700030000058586007001,217356489458129673369478215675283194192564837843791562921835746734612958586947321,0.01337620004778728,46,57,11
300498002008153400009000310120800006485070031790300005001000980002739100900681003,317498652268153479549267318123845796485976231796312845631524987852739164974681523,0.01305860001593828,41,70,29
257010469160020075400060008300206007082090640000154000000030000043070250670000013,257318469168429375439567128314286597582793641796154832921635784843971256675842913,0.01348439999856055,44,79,35
200040005060159040450000013100000004580090062600512008001923500030671020006485700,217348695368159247459267813172836954583794162694512378741923586835671429926485731,0.01377199997659773,42,86,44
100357009050249070070000040501000706680070054400615008003060800014732960000891000,146357289358249671279186543531428796682973154497615328923564817814732965765891432,0.01405789999989793,42,105,63
300248679000050830080000200104500007738490026506700003010000700000010460800627391,351248679267159834489376215124563987738491526596782143612934758973815462845627391,0.01428579998901114,42,105,63
107246509050793060009050200302000906510389042700000001021000390000030000970625018,137246589258793164469158273382417956516389742794562831621874395845931627973625418,0.01415699999779463,41,49,8
206458709500030008080167020103000806060000010700306002601985204000040000870623051,216458739547239168389167425123574896465892317798316542631985274952741683874623951,0.01330970000708476,41,52,11
246100380100300007009060005530704000004080700000506013400030900900001004085002631,246157389158349267379268145532714896614983752897526413421635978963871524785492631,0.01376810000510886,46,84,38
160237089000149000009050300200306007690070021754010963002000600030504070800961005,165237489328149756479658312281396547693475821754812963512783694936524178847961235,0.01328990003094077,41,53,12
047103560100000009360070021510704096403865102000010000600357004000080000075902610,247193568158426739369578421512734896493865172786219345621357984934681257875942613,0.01285230001667514,42,50,8
086203479200100308300070052402500006063780900708400003600040097800900605075801234,186253479257194368349678152412539786563782941798416523621345897834927615975861234,0.01311659999191761,38,51,13
204571089000340200570068400300050006485600071700080004820036700000810900903725068,234571689168349257579268413312457896485692371796183524821936745657814932943725168,0.01371960004325956,39,64,25
307189500000035740000000810580000976090000050673000024014000000026850000005764201,347189562168235749259476813581342976492617358673598124714923685926851437835764291,0.01409539999440312,45,105,60
108000307560000081070080040300407008006592700005010400801935604900040005054020130,148256397569374281273189546312467958486592713795813462821935674937641825654728139,0.01499220001278445,43,148,105
106045789200007304400390001002780000584609000009530000700820005800006403903051872,136245789298167354457398621312784596584619237679532148741823965825976413963451872,0.01326079998398200,40,64,24
051400367308000004470500000137080050000604000090050872000002045700000601946005720,251498367368127594479536218137289456582674139694351872813762945725943681946815723,0.01314060000004247,45,51,6
240050019108209304509104602000040000480965031000010000003507400900030007756090123,247356819168279354539184672371842965482965731695713248813527496924631587756498123,0.01583330001449212,41,182,141
038000760170306089690000035200080001307592608009010200000935000900761004760020013,538149762172356489694278135256487391317592648849613257421935876983761524765824913,0.01492679998045787,41,158,117
100040009370000054409000701210050076500781002000462000040975030001020900700814005,165247389378196254429538761214359876536781492987462513642975138851623947793814625,0.02871579997008666,44,1046,1002
307251608000009042209000310410000006573096001890000007601000870000008059905742103,347251698158369742269487315412573986573896421896124537621935874734618259985742163,0.01569520001066849,41,224,183
107302508008090100300581004010639080070000030893000621620050047700010002005274800,147362598258497163369581274412639785576128439893745621621853947784916352935274816,0.01312710001366213,41,47,6
320648019008030400409050208210000084580000093704803102030000020600080005070926040,327648519158239467469157238213795684586412793794863152931574826642381975875926341,0.01322129997424781,42,69,27
200375004090080050408000103530000087620897031700503002045000620800942005900651008,216375894397184256458269173531426987624897531789513462145738629863942715972651348,0.01273810002021492,40,42,2
300297105000036070079000320512300004783040012694700008027000890000024050900873201,346297185258136479179458326512389764783645912694712538427561893831924657965873241,0.01276249997317791,39,53,14
402509103075238460000070000050080090713090845809000307520040086900020004600701002,482569173175238469396174258254387691713692845869415327521943786937826514648751932,0.01316489995224401,41,51,10
190000057248070169300169004002513800000496000000782000700050008034000670905807402,196248357248375169357169284472513896583496721619782543721654938834921675965837412,0.01366530003724620,41,79,38
140000078360040091200000006401539607002060900000712000500623009026000430937804162,145396278368247591279185346481539627752468913693712854514623789826971435937854162,0.01352009997935966,40,54,14
200138400040059100000007035500000689080090070963000004610800000004670010005912006,256138497347259168198467235571324689482596371963781524619843752824675913735912846,0.01396919996477664,46,86,40
140200806050160403009080002400308000003070900000502008900020500601053040805004067,147239856258167493369485712412398675583671924796542138934726581671853249825914367,0.01462230004835874,46,138,92
201400708300000652600250041006308009030592800008706004800970023700000985903800107,251463798374189652689257341126348579437592816598716234865971423712634985943825167,0.01577129994984716,40,168,128
417208659508109307000050000100624008000010000005803200700000006840090075956781432,417238659528169347369457821173624598284915763695873214731542986842396175956781432,0.01406860002316535,40,48,8
150200009268009007079000125500700000610000094000003006431000970900800463700004012,154237689268159347379468125592746831613582794847913256431625978925871463786394512,0.01508120005019009,45,140,95
347158209000009008000060450100000095280000031590000002068030000700600000902874316,347158269625349178819267453173482695284596731596713842468931527731625984952874316,0.03017169999657199,45,996,951
007036590200197400360050000401800059680900731503600042830010000700369200006084310,147236598258197463369458127471823659682945731593671842834512976715369284926784315,0.01311629998963326,39,49,10
401279305200145009070060020105000908380000041700010003000050000043927510007681400,461279385238145679579368124125734968386592741794816253612453897843927516957681432,0.01346050004940480,42,75,33
103248506400109003020060080731000965860000047900070001300000008007836400058914730,173248596486159273529367184731482965862591347945673821394725618217836459658914732,0.01319699996383861,40,56,16
038469510100000002570030068300000009002301700007285400700853004040716020856000173,238469517169578342574132968315647289482391756697285431721853694943716825856924173,0.01378199999453500,40,89,49
050070289407200006238000000002065040600809003080120500000000832700001604849030010,156374289497218356238956471312765948675849123984123567561497832723581694849632715,0.01361230004113168,45,71,26
147230096250100003009000802000080740700624138000090260004000607830500004976840051,147238596258169473369457812612385749795624138483791265524913687831576924976842351,0.01353360002394766,40,71,31
050046079468000003300100000004710060100482007080069200000004005900000482840920010,251346879468297153379158624524713968196482537783569241612834795935671482847925316,0.01344399998197332,46,57,11
036010790100000006200346001002060900600105007790020064000000000940601025863752419,436518792158279346279346581312467958684195237795823164521984673947631825863752419,0.01355289999628440,42,80,38
016350000408109000300400108180000693503206417760000825600700304905801000047630000,216358749478169532359427168182574693593286417764913825621795384935841276847632951,0.01437460002489388,40,130,90
340010067100368009000407000071030690400659001000070000004080900825000713930020084,349215867157368249268497135571834692482659371693172458714583926825946713936721584,0.01451980002457276,44,141,97
350040079169000003072300005001430000000712000000098400500004780800000394940060052,358146279169257843472389615281435967694712538735698421513924786826571394947863152,0.01309569994919002,46,55,9
100207689000008305009405100721300006893600004654900003007506900000003507500709431,145237689276198345389465172721354896893671254654982713437516928912843567568729431,0.01336380001157522,40,72,32
150600239208009057070054008000430000002175384000890000010023006905008043830900725,154687239268319457379254618581436972692175384743892561417523896925768143836941725,0.01409099996089935,40,121,81
137400809048000005500000014310024900006301582980065400600000098053000006894600203,137456829248139675569278314315824967476391582982765431621543798753982146894617253,0.01511019997997209,41,165,124
105279604008030500760845021000050000406000702500408003620080035850000017903502806,135279684248136579769845321312657498486391752597428163621784935854963217973512846,0.01332520000869408,40,60,20
400507109000290054500030076010002900206000705008400020950040002620051000804309001,432567189167298354589134276315672948246983715798415623951746832623851497874329561,0.01337760000023991,45,64,19
102305709005080100000167000040050070517020394800000001920030017730816052600702008,162345789475289163389167245243951876517628394896473521928534617734816952651792438,0.01437490002717823,41,130,89
150273089070060010629000357012000970500000006700194002001946700000712000200308001,154273689378569214629481357412635978593827146786194532831946725945712863267358491,0.01296159997582436,42,55,13
100205608000069037369000500403520000582090046601780000914000300000013064800902105,147235698258169437369478521473526819582391746691784253914657382725813964836942175,0.01292820001253858,41,44,3
104257806007080050509006000310500008470028319690700002701005000006040030903871605,134257896267189453589436271312594768475628319698713542721365984856942137943871625,0.01307779998751357,40,52,12
200356009058020360309000205400000003576030428890000056001000500700815002900642001,247356819158429367369187245412568973576931428893274156621793584734815692985642731,0.01395120000233874,42,120,78
130245000200080030908006210400607009860390027700804003304002980500070040690418000,136245798247189536958736214413627859865391427729854163374562981581973642692418375,0.01285999995889142,41,52,11
147300529000009006360200107000090800570812604000040200620900708000001002834600951,147368529258179436369254187412596873573812694986743215621935748795481362834627951,0.01295250002294779,42,56,14
341206598200105007570040026003080700700409001800010004132060875000000000904837602,341276598268195437579348126413682759726459381895713264132964875687521943954837612,0.01331010001013055,40,56,16
408030107000479000070080040014658730050000060900020004000542000742000356090763020,468235197123479685579186243214658739357914862986327514631542978742891356895763421,0.01387880003312603,44,106,62
205040609060050040079080150124060978000000000800010004030694020542000796080725030,215347689368159247479286153124563978693478512857912364731694825542831796986725431,0.01312300004065037,42,50,8
100230097260009040080460021500070804000000000708090003420013080030700019970046005,154238697267159348389467521592371864613584972748692153425913786836725419971846235,0.01694960001623258,45,289,244
407030809560070034039060750300020008000000000600847001010684090943000286050392010,427135869568279134139468752371526948284913675695847321712684593943751286856392417,0.01333040004828945,42,79,37
240167305300420070090380000000000807837200956000000103010830000600910080980756201,248167395351429678796385412125693847837241956469578123512834769673912584984756231,0.01416870002867654,42,102,60
200469008140005090000080240000040809486000523705030000021090000050700061600351002,237469158148275396569183247312546879486917523795832614821694735953728461674351982,0.01358709996566176,45,75,30
350000079060050040409070105210587096500603002800104003000040000731962584900030001,352418679167259348489376125213587496574693812896124753625841937731962584948735261,0.01329609996173531,41,62,21
340200708007108034509430102130004905400300200790002603203940806004506079950700401,341265798627198534589437162132674985468359217795812643273941856814526379956783421,0.01324170001316816,36,53,17
400000578000000009309080014104702095200403001790805302610050403900000000857000006,461239578528174639379586214134762895285493761796815342612957483943628157857341926,0.02276989998063073,45,705,660
310209048050167030000080000123040987600000002905000403700020004542000396896030721,317259648458167239269483175123645987674398512985712463731926854542871396896534721,0.01762429997324944,40,305,265
230000018050030090400070005360000049000000000584601327719843562603705904040962070,236459718157238496498176235361527849972384651584691327719843562623715984845962173,0.01274750003358349,39,42,3
350109076060070040400030009010763080000000000597000463821050634905426807700080002,358149276169275348472638159214763985683594721597812463821957634935426817746381592,0.01778059999924153,41,298,257
050001089000389406400076120210400008000000000800003074021930007608712000940800010,356241789172389456489576123213457698794628531865193274521934867638712945947865312,0.01475479995133355,45,145,100
310209048050167030000080000100040007000308000985702463701926804002000300806030701,317259648458167239269483175123645987674398512985712463731926854542871396896534721,0.01348839997081086,42,72,30
200500837050307004309080050581000003000106000700000192010020309900803010837001005,246519837158367924379284651581972463492136578763458192614725389925843716837691245,0.01377449999563396,45,102,57
358000179160357082000090000280030096000702000637010524800523007000000000705189203,358246179169357482472891635281435796594762318637918524816523947923674851745189263,0.01313590002246201,41,50,9
057190048100000007480005000301002760500030002092700103000200075900000004730049620,257196348163428597489375216341852769576931482892764153614283975925617834738549621,0.01624520000768825,46,247,201
030000050208169307079030180010706090500010002607000403901070508700805001060321070,136487259258169347479532186312746895584913762697258413921674538743895621865321974,0.01364820002345368,42,68,26
360209080100456903400003560013504000704390006096807000800001640600748302940605010,365279481178456923429183567213564879784392156596817234837921645651748392942635718,0.01433690002886578,38,110,72
040200019200091600160480000501600090400070003090005201000032086005760004830004020,347256819258391647169487352571623498482179563693845271714532986925768134836914725,0.01342430000659078,46,54,8
005207093130400006279060000312500000500000007000004325000040569900001082750809400,465217893138495276279368154312576948584932617697184325821743569943651782756829431,0.01414109999313951,45,113,68
207301080050629004369004000410000006600000001900000037000400798700218060030905402,247351689158629374369784125412837956673592841985146237521463798794218563836975412,0.01892850000876933,45,385,340
000317069160092003009000000410700008503904607700008032000000300900830046630549000,254317869168492573379685124412763958583924617796158432841276395925831746637549281,0.01675880001857877,45,262,217
200037080350269000000080006612300005403000702700002643900020000000941028020750001,246137589358269174179485236612374895483596712795812643931628457567941328824753961,0.01312879996839911,45,59,14
200137009050269070109080206610000095400000002790802043031020450000941000820050061,246137589358269174179485236612374895483596712795812643931628457567941328824753961,0.01299230003496632,41,44,3
145397268000125000209060501403602905500000006607000302050040020900010003830050014,145397268368125497279468531413672985582934176697581342751843629924716853836259714,0.01393329998245463,41,93,52
145397268300125007009060500410000085500000006007000300750040029900716003006050700,145397268368125497279468531413672985582934176697581342751843629924716853836259714,0.01659800001652911,43,227,184
340250000100469000009080005461000907502000306703000284900040600000831009000076042,346257891158469723279183465461328957582794316793615284917542638624831579835976142,0.01394029997754842,45,96,51
200570409350429000000036005103000500504000803009000102600740000000951067905083004,216578439357429681498136725123894576564217893789365142631742958842951367975683214,0.01384460000554100,45,91,46
150038090402197038300050100000304009508071204000502003800010900601729085970043020,157238496462197538389456172216384759538971264794562813823615947641729385975843621,0.01308310002787039,39,57,18
040368970160409003389100406002093008600080004008014009521900807970801005030745190,245368971167459283389172456412593768693287514758614329521936847974821635836745192,0.01346440002089366,36,63,27
028346570059000620674000831005060700400090002000010000000825000590030087063974210,128346579359187624674259831215463798436798152987512346741825963592631487863974215,0.02195710001979023,42,525,483
045687230360102054200000001000030000450020017000741000020374080930000075087915340,145687239368192754279453861712536498453829617896741523521374986934268175687915342,0.01307740004267544,41,53,12
047328000250100074300400000010004908780591632090006107900800000430600089076945000,147328596258169374369457821612734958784591632593286147921873465435612789876945213,0.01337569998577237,41,57,16
147239050250000000300504100421000087570900403893000015600703500730000000985621030,147239856258167349369584172421356987576918423893472615612743598734895261985621734,0.01308530004462227,40,44,4
350217096100349007400000001000605000580000074090824010010702050920000068837956142,358217496162349587479568321241675839586193274793824615614782953925431768837956142,0.01366659998893738,39,72,33
050149060000572000400060009132090475600050002590000036900624008700000003046735290,258149367369572184471368529132896475687453912594217836913624758725981643846735291,0.01486890000523999,42,161,119
457163800100000000000087030301500068002010400940008207010870000000000001006341572,457163829138295746269487135371524968682719453945638217513872694724956381896341572,0.01391460001468658,46,91,45
310560007067009203000000000170400005680215074900006028000000000809600450700024081,314562897567189243298347516172498635683215974945736128421853769839671452756924381,0.01396559999557212,46,89,43
250147039000259000000000000124070985500000002709000301000435000970020064845090123,256147839387259416491368257124673985538914672769582341612435798973821564845796123,0.01735300000291318,43,263,220
305040708060183090480060032040326080706891503000000000000738000000000000054612370,315249768267183495489567132541326987726891543938475216192738654673954821854612379,0.01440620003268123,44,115,71
358109002000030009270060030010000078002654300590000040020040057600080000900506813,358179462164235789279468135416392578782654391593817246821943657635781924947526813,0.01451479998650029,46,129,83
250367091000208000380050072000483000040709020708506103420000087900841006806902405,254367891167298354389154672512483769643719528798526143421635987975841236836972415,0.01292090001516044,39,46,7
200167009460352078170080026302548607000000000004010800000734000035020760040090030,258167349469352178173489526312548697586973412794216853621734985935821764847695231,0.01484179997351021,43,143,100
200040009360129057070080020502691704000000000706030802000050000047813260053060940,215347689368129457479586123582691734134278596796435812621954378947813265853762941,0.01327389996731654,43,57,14
302567108180293065560010072205836709000070000700040006000354000003080200050000010,342567198187293465569418372215836749436975821798142536621354987973681254854729613,0.02482360001886263,43,672,629
217300609400060007060000010000030894583904261000020573020000040900010002846700105,217348659458169327369257418172635894583974261694821573721583946935416782846792135,0.01682740001706406,43,256,213
351247689000030000279000314020706090500090008800010006010973040900050007780020031,351247689468139752279568314124786593536492178897315426612973845943851267785624931,0.01376469997921959,42,97,55
127300589000000002960008017040030050071205846080060070610004098000000005895600724,127346589458179632963528417246837951371295846589461273612754398734982165895613724,0.01508330000797287,42,166,124
010540682060007000400008000520300794800090005694005023000600008000800030786023040,317549682268137459459268317521386794873492165694715823132654978945871236786923541,0.01375789998564869,46,70,24
310248079240109086508306102420080057000090000060010020050704090004901700030060010,316248579247159386598376142421683957873592461965417823152734698684921735739865214,0.01499499997589737,42,140,98
140020690008100007000400015420581069081940002790236041000600074004700006970010520,147325698258169437369478215423581769681947352795236841812653974534792186976814523,0.01443410001229495,40,87,47
260308097470000026509070401120507069085090270796080135800000002900010008050020010,261348597478159326539276481124537869385691274796482135813965742942713658657824913,0.01341229997342452,40,61,21
360100240000000005540260079000395080836710502000628010420830057000000004780500360,367159248192487635548263179214395786836714592975628413421836957653971824789542361,0.01316149998456240,42,47,5
140258093300000007000407000400613008603974105000000000570040069000090000936825714,147258693358169247269437581425613978683974125791582436572341869814796352936825714,0.01496650004992262,43,144,101
160258790005000008000060045500601289917080506600503471000020067002000004830714950,164258793375149628289367145543671289917482536628593471491825367752936814836714952,0.01964770001359284,39,451,412
040316090100000003000279000300050009400000006090603050730040065002861700684537912,248316597179485623563279148316754289425198376897623451731942865952861734684537912,0.01801689999410883,43,328,285
200148360061000008080530007000607095926050801000801036090460002035000004700985610,257148369361279548489536127813627495926354871574891236198463752635712984742985613,0.01327229995513335,41,56,15
510037060602000009080090215100502000006080100000604003421060050900000301070940082,519237468642158739783496215134572896256389174897614523421863957968725341375941682,0.01629350002622232,46,240,194
100200500200009300380070162460900000502304906000006047624050093005600008008002001,146238579257169384389475162461927835572384916893516247624851793715693428938742651,0.01475750003010035,45,136,91
007040800400000001060108070312875649704060502000304000620030084043602150870010026,137246895458793261269158473312875649784961532596324718621537984943682157875419326,0.01284489996032789,40,40,0
460315892008000103030200457000503008304160500000807001010600985003000206850921734,467315892528479163139286457271593648384162579695847321712634985943758216856921734,0.01437320001423359,38,108,70
137420000208000007560000240000004038785263401000001072420000850903000006876190000,137426985248359167569718243612974538785263491394581672421637859953842716876195324,0.01838480000151321,43,364,321
105070902240189056680000017000508000070090040093060120021943860300000004060857030,135476982247189356689325417412538679876291543593764128721943865358612794964857231,0.01452169998083264,41,126,85
000654000108000403069000250310806079506392804080000020620080045790000081805961702,237654198158279463469138257312846579576392814984517326621783945793425681845961732,0.01299110002582893,39,39,0
000456000208109306069020750041000890500080003896000125600040008980000032703895604,137456289258179346469328751341562897572981463896734125615243978984617532723895614,0.01387969998177141,40,97,57
351248700200000000489060000100004390600902007098500002000030974000000006003796251,351248769276159483489367125125674398634982517798513642562831974917425836843796251,0.01655790000222623,45,239,194
246381050000000086098050400000723590000000000083465000004070930720000000030516274,246381759157249386398657412461723598572198643983465127614872935725934861839516274,0.01317819999530911,45,55,10
037568140100000005049020760002080500400296003080305070690040057700000004804937601,237568149168479235549123768312784596475296813986315472691842357723651984854937621,0.01309089997084811,41,49,8
006308700307109402400070006031080920004000500060504070200756009640801037070423050,126348795357169482498275316531687924784912563962534178213756849645891237879423651,0.01319209998473525,41,63,22
007004098058300001400100003010090037384000926790080040600005004800002510940800300,137524698258369471469178253512496837384751926796283145621935784873642519945817362,0.01361299998825416,45,93,48
100308005307169402400070006001000900784010563960504078000706000600891007870020051,126348795357169482498275316531687924784912563962534178213756849645891237879423651,0.01305810001213104,40,53,13
004201079100479003200000005040003008602040301700100020400000006900814007830506400,364251879158479263279368145541623798682947351793185624415732986926814537837596412,0.01371159998234361,46,105,59
300408005107269304098050120003000800589020413740000062600584007900601008070030040,326418795157269384498357126263145879589726413741893562612584937934671258875932641,0.01281730004120618,40,40,0
100309002209157403400060005004000800607090501980203047500000008740901056890030014,158349762269157483473862195314576829627498531985213647531624978742981356896735214,0.01322730001993477,41,55,14
300108009400239006200060003102000608643080915870000024500000007730801062960020031,356178249487239156219465783192354678643782915875916324521643897734891562968527431,0.03264330001547933,41,1301,1260
006005089307200000400067502200600908003408200904002006809520003000001405740900800,126345789357289164498167532271653948563498217984712356819524673632871495745936821,0.01343330001691356,45,68,23
008267050209300000000050108400503086590000034680704002704030000000001603030875200,148267359259318467367459128471523986592186734683794512714632895825941673936875241,0.01315220003016293,45,49,4
008235700300000002000000000210050098580000074700408001621040957935020486840596013,168235749359174862472689135214357698586912374793468521621843957935721486847596213,0.01754339999752119,40,298,258
047368520300000006060000030400937002700681004800205007002000800901402703674010295,147368529358129476269574138415937682723681954896245317532796841981452763674813295,0.01696610002545640,41,284,243
137460080200079060060000107300500006570000039900004001801000090040950008090042613,137465982258179364469283157312597846574618239986324571821736495643951728795842613,0.01651869999477640,45,249,204
501260070300000080009300024430002008100896003200400051710003400050000007060051902,541268379327149586689375124436512798175896243298437651712983465953624817864751932,0.01499880000483245,46,151,105
017050820200000007000000000100639008340785092790402036671020984030060010900871003,417356829269148357583297641125639478346785192798412536671523984832964715954871263,0.01707090000854805,41,296,255
157200380408300005000000207200005090503904702090800004601000000900003601075009423,157246389428397165369158247214735896583964712796821534631472958942583671875619423,0.01561310002580285,45,201,156
017463590300000004060000010620709053500010002000602000030000080945286731876931425,217463598358197264469825317621749853594318672783652149132574986945286731876931425,0.01342450000811368,39,54,15
158237400302009058070000000000004807534098026000002504020000000703005041945861200,158237469362149758479586312216354897534798126897612534621473985783925641945861273,0.01295150001533329,42,46,4
005060700601000304840309016100070009700198002980504037203706905008010600560030071,325461798691287354847359216152673849734198562986524137213746985478915623569832471,0.01298769999993965,40,47,7
158230060302000050070000002200004007530798026800600004600000080080000601040061273,158237469362149758479586312216354897534798126897612534621473985783925641945861273,0.01560009998502210,46,188,142
158070346300050007079000120200080009580792061700603008020105080000040000900827003,158279346362451897479368125216584739583792461794613258627135984831946572945827613,0.01300099998479709,43,65,22
407050306500060007060000080300090008870020014106040703040532070050080030903417602,417258396538169247269374185324791568875623914196845723641532879752986431983417652,0.01282519998494536,43,55,12
421300698608049070070000001107026005200570040504093007010000004305084010846700539,421357698658149273973268451137426985289571346564893127712935864395684712846712539,0.01276260003214702,39,47,8
317040596060050030000000000105493608630080019790010054070000060040725080800961002,317248596462159837589376421125493678634587219798612354271834965946725183853961742,0.01708850002614781,42,310,268
207608301000793000000000000402060809500020004706481503000509000804172905975040132,247658391158793246369214758412365879583927614796481523621539487834172965975846132,0.01305880001746118,41,45,4
150060049000070000200000006301090708004010900905627403800401007706902804549080231,157268349463179582298345176321594768674813925985627413832451697716932854549786231,0.01574210001854226,41,206,165
420136789608000050070000000246000507580690032193000806030000000902000010860915273,425136789618279354379458621246381597587694132193527846731842965952763418864915273,0.01337520004017279,41,62,21
420306089050040020360205047201408605680901072500000003010000050900104008846592731,427316589158749326369285147271438695683951472594627813712863954935174268846592731,0.01295509998453781,37,39,2
150247089000060000009000100502030907003090800804715603200000008708306501065070430,156247389387169254429583176512638947673492815894715623231954768748326591965871432,0.01336849998915568,43,75,32
040530691105009000300002000402075809000090000807610205000700003000900506986053020,248537691165849372379162458412375869653298714897614235521786943734921586986453127,0.01402030000463128,46,87,41
300246001000397000009000700201060508003070400594010673000504000805609107046080320,357246981168397254429158736271463598683975412594812673712534869835629147946781325,0.01437780004926026,43,135,92
300206001060090050409108706201060508003070400594010673000504000805609107046080320,357246981168397254429158736271463598683975412594812673712534869835629147946781325,0.01294559997040778,40,46,6
207000109108204000060000284502070403476023098803060701020000945704901000905000807,247386159158294376369517284512879463476123598893465721621738945784951632935642817,0.01370290003251284,40,81,41
010006409408009007069070285104080006830012074906040002041020698602001003090008501,217856439458239167369174285124987356835612974976345812541723698682591743793468521,0.01418580004246905,39,126,87
340009100100030769200060004461000508500000001703000246800050003924070005005400027,346789152158234769279165384461927538582346971793518246817652493924873615635491827,0.01639379997504875,45,248,203
300000009100050006079030140002080900580792061607504208700963004904070602060401090,356147829148259376279638145412386957583792461697514238721963584934875612865421793,0.01332289999118075,41,74,33
201050809400109007500060003128543976000296000600000005372914658010602030006000100,261357849483129567597468213128543976754296381639871425372914658915682734846735192,0.01541980000911281,40,139,99
107352608058060340300070005502080409000090000980704062020030050704020806005000700,147352698258169347369478215512683479476295183983714562621837954794521836835946721,0.01330249995226040,44,68,24
207030508150492067300050004002378900400010003890000015021040870704209601000060000,247136598158492367369857124512378946476915283893624715621543879734289651985761432,0.01346809999085963,42,54,12
307050401180006003524090678200000009075912006800000005631040982940001007702060304,367258491189476253524193678213685749475912836896734125631547982948321567752869314,0.01436509995255619,39,94,55
296317458003468200400050003307000905000090000820030047080020090700901006905070302,296317458153468279478259163317684925564792831829135647681523794732941586945876312,0.01777500001480803,42,294,252
351040789000179000209080106102090607000050000500000001014502970000817000807060502,351246789468179235279385146182493657793651824546728391614532978925817463837964512,0.01415409997571260,44,98,54
107030896200109407060470051410000500500814000890000300020980045600702109905040723,147235896258169437369478251412396578573814962896527314721983645634752189985641723,0.01315840001916513,39,53,14
146050308350009000070010006402000059000921000690000201800030070000100083905070412,146257398358649127279318546412763859583921764697584231861432975724195683935876412,0.02007219998631626,46,413,367
348060257100508006670040098000406000000392000500000004701604905950781043804030702,348169257129578436675243198213456879487392561596817324731624985952781643864935712,0.01312130002770573,40,50,10
147060239000349000009070500000090000000218000906507401601953804700080002805020103,147865239258349716369172548512496387473218695986537421621953874734681952895724163,0.01302090001991019,43,44,1
300240695060108007074000082120000903485690000790000508031000079040901006900830214,318247695269158437574369182126785943485693721793412568631524879842971356957836214,0.01353980001294985,40,68,28
135060289060009007000000100304500010600832004050001803003000000900700030547020691,135467289268159347479283156384576912691832574752941863813694725926715438547328691,0.01380929996958002,46,59,13
457060238000354000360080054020000090500813007700906003600090005940000061875030942,457169238218354679369287154123745896596813427784926513631492785942578361875631942,0.01418180001201108,41,115,74
453010782000040009279000106300500408680491000700800501521000604000020005847060923,453619782168247359279358146312576498685491237794832561521983674936724815847165923,0.01305579999461770,40,56,16
107060803300415009000000000015040390704050206890000054900873002680591037070020080,157269843328415679469387125215746398734958216896132754941873562682591437573624981,0.02041260001715273,42,530,488
100205090208169037000000001412300070503810062896500010000000005604752089900601020,147235896258169437369478251412396578573814962896527314721983645634752189985641723,0.01296939997700974,41,49,8
351040697470000850000100000100402085000080000590706002000007000024000078765030129,351248697472369851689175243136492785247583916598716432813927564924651378765834129,0.01322040002560243,46,63,17
457268139900040008000000000201050807070090020600427001504080703020000080896030512,457268139932145678168379245241653897375891426689427351514982763723516984896734512,0.01387590001104400,42,136,94
410060529200000080600290007102000095090080040740000103500036004070000008834020051,417368529259147386683295417162473895395681742748952163521836974976514238834729651,0.01287070004036650,46,67,21
007201089158000000269070050012003070600000003080900510020030498000000761870109300,347251689158496237269378154412583976695712843783964512521637498934825761876149325,0.02764460002072155,45,895,850
468030019020007068570068004200006903630980000800004605940023006050001092382050071,468235719123497568579168234214576983635982147897314625941723856756841392382659471,0.01303559995722026,39,48,9
100095078408020000279038104001000000340000065000000300507860493000010506860350002,136495278458127639279638154681543927342971865795286341517862493923714586864359712,0.01672289997804910,45,252,207
158267349060000070470389015000090000500000003096000450021070530930000086800635002,158267349369451278472389615213594867584716923796823451621978534935142786847635192,0.03400650003459305,42,1256,1214
200019068100000000089470025005067082010000070790240600520093840000000009970850001,257319468164582397389476125435167982612938574798245613521793846843621759976854231,0.02076370001304895,45,454,409
418237569060549070570060043000070000830000016796000432280753094000000000900604001,418237569362549178579168243124376985835492716796815432281753694643921857957684321,0.01373080001212656,40,95,55
100036089258009000309005012004002008600000001900700200420800907000900846890540003,147236589258179634369485712514692378672358491983714265421863957735921846896547123,0.01843240001471713,45,343,298
136458279000030000498060351000302000900000007375000426700684003540000062800925004,136458279257139648498267351614372985982546137375891426721684593549713862863925714,0.01366749999579042,40,70,30
210060089050179060460020037020897040600000008890000021001683900030000070900752003,217364589358179264469528137123897645674215398895436721741683952532941876986752413,0.01382540003396571,43,50,7
047263580000104000360578014000010000580000027690050048014635890900000006800729001,147263589258194673369578214473812965581946327692357148714635892925481736836729451,0.01370369998039678,41,80,39
235010789067398240009020100070040060500000007026000490612070953900000002700932004,235416789167398245489527136371249568594681327826753491612874953943165872758932614,0.01803380000637844,41,330,289
007468059050000060200751040000080002580104036600070000010925004020000070940817500,137468259458239167269751348371586492582194736694372815713925684825643971946817523,0.01335630001267418,45,60,15
000030000009148200270906041020000070690000084780010032517364829800000006960825013,146237598359148267278956341421683975693572184785419632517364829832791456964825713,0.01360609999392182,40,76,36
040237098300040000008900341021680075690002104085410032007300829800090000060825013,146237598359148267278956341421683975693572184785419632517364829832791456964825713,0.01308610005071387,38,42,4
005000769167050000380407215000000058650091430000000026510902684926080000004000592,245138769167259843389467215431726958652891437798345126513972684926584371874613592,0.01675790001172572,41,301,260
040010078000270503200008041052030009000492000900080720520900007704021000830040010,345619278168274593279358641452137869687492135913586724521963487794821356836745912,0.01292770000873134,46,56,10
230000015108020309569103248000000000000531000690040032703050904020010060056080720,237498615148625379569173248381962457472531896695847132713256984824719563956384721,0.02833130001090467,43,901,858
350401079109030508274508163000050000000972000700000002901040605600010004045020730,358461279169237548274598163412356897583972416796184352921743685637815924845629731,0.02424030000111088,43,599,556
245000060107250003380407205000020058000891407000040026510902604906580001874000090,245138769167259843389467215431726958652891437798345126513972684926584371874613592,0.01448670000536367,40,97,57
030000080250080064490607025000060000000328000680090032501473806800050007069010540,136245789257189364498637125312564978974328651685791432521473896843956217769812543,0.01559640001505613,44,159,115
410000089320060074569708132105090408000304000790000065800070006002981700073020850,417235689328169574569748132135697428286354917794812365841573296652981743973426851,0.01339700003154576,40,48,8
136200070400170206070306104500080017000792005600010023010905608900860702865400090,136248579458179236279356184524683917381792465697514823712935648943861752865427391,0.01266259996918961,39,39,0
105026009097000016400009235600040000720803561800010000300002958072000043906034002,135426789297358416468179235613245897724893561859617324341762958572981643986534172,0.01295149995712563,42,45,3
300607902086000307090350460400030090860501034900080010010870620028000103600104805,345617982186249357297358461451736298862591734973482516514873629728965143639124875,0.01324980001663789,41,78,37
210340905300000204070008010060072009500806001800410050020700090703000008905031027,216347985358169274479258316164572839532896741897413652621784593743925168985631427,0.01335039996774867,45,55,10
258140007160000204000009050006000029480503076590000400020700000604000013900061742,258146397169357284743289651316478529482593176597612438821734965674925813935861742,0.01706650003325194,45,308,263
205080706007302800080070020000268000870409051090010080013000960908040507700953008,235184796167392845489576123351268479872439651694715382513827964928641537746953218,0.01308050000807270,43,56,13
347156928208000106000070000000743000480912037090000010001000700900827001805461203,347156928258394176169278345512743869486912537793685412621539784934827651875461293,0.01283560000592843,41,49,8
251030089000100470000008003012000090034289510060000230100600000078004000940050762,251437689386192475497568123512346897734289516869715234125673948678924351943851762,0.01328980003017932,46,64,18
108207604302459108000168000000040000500020007090603010601000809925010763007596200,158237694362459178479168325213745986586921437794683512641372859925814763837596241,0.01331059995573014,41,55,14
306040709000108000000070000100090008034856970008010200001904800940507012057621390,316245789479168523582379146165792438234856971798413265621934857943587612857621394,0.01516719994833693,43,174,131
201030609000000000007568100512306897034289510800010004100000008000020000943851762,251437689386192475497568123512346897734289516869715234125673948678924351943851762,0.01340270001674071,41,67,26
126050478300200590090000000260070809005104367470090205010000000700900620839010754,126359478347281596598467132261573849985124367473896215612745983754938621839612754,0.01407370000379160,41,108,67
354060798060080030702395104240109056010853020508020301000000000005000600800942003,354261798169487235782395164243179856617853429598624371421536987935718642876942513,0.01301789999706671,41,49,8
145070963000090000279050814402000109000931000900080006500000007000615000830729051,145278963368194725279356814482567139657931248913482576521843697794615382836729451,0.01335449999896809,44,56,12
237050460100009050069400108300000780000702000085000002401003890050800004076040231,237158469148269357569437128312594786694782513785316942421673895953821674876945231,0.01424459996633232,45,129,84
251030689000090000007060100502040807030289010800010004005673900000000000943851762,251437689386192475497568123512346897734289516869715234125673948678924351943851762,0.01339940004982054,43,81,38
258040796100270000000068102302000004080917253507000001000094305700130000936050417,258341796163279548479568132312685974684917253597423681821794365745136829936852417,0.01305260002845898,40,46,6
340010028000472000079000610481000369050030080700080005500297006800503001930861052,345619728168472593279358614481725369652934187793186245514297836826543971937861452,0.01313109998591244,41,57,16
350090401100850030479016005003060007004073612007020004721089003800740020940030108,358297461162854739479316285213465897584973612697128354721689543835741926946532178,0.01296249998267740,39,84,45
031465000450100002009000004000306950340070086067502000500000800700003025000759430,231465798458197362679238514182346957345971286967582143513624879794813625826759431,0.01326500001596287,46,74,28
057146089100035067062000500001903075500600094008407021014000900900014036036579042,357146289189235467462798513241983675573621894698457321714362958925814736836579142,0.01345309999305755,37,57,20
047196058100203009000000037402307006780900510605804002000000043800701005076435021,347196258158273469269548137412357986783962514695814372521689743834721695976435821,0.01329829997848719,40,59,19
000427000400109005089365740000601000100030002068294150902040607000070000857010324,531427896476189235289365741324651978195738462768294153912543687643872519857916324,0.01522189995739609,42,173,131
000317000100209005079568120400605007007192400003704200701000809050020040934806512,245317698168249375379568124412635987587192436693784251721453869856921743934876512,0.01274480001302436,39,40,1
047006208100070000009540137402307986700060500605804372001680743800020000076005801,347196258158273469269548137412357986783962514695814372521689743834721695976435821,0.01328310003736988,38,50,12
257060389108203607009070100000000000680000074795000813070902060800705001934816725,257461389148293657369578142412387596683159274795624813571932468826745931934816725,0.01851739996345714,38,368,330
047138506000200007060000021010700603030010050806005070520000060600004000904621730,247138596158269347369457821415792683732816954896345172521973468673584219984621735,0.01517269999021664,46,159,113
046587310000109000100040006400000008063090140985406732020634050600000004594020863,246587319358169427179243586412375698763892145985416732827634951631958274594721863,0.01366709999274462,40,93,53
126478359058000240000020000500000003703952406804000501007000100280701064601040805,126478359358196247479523618562814793713952486894367521947685132285731964631249875,0.01601909997407347,41,208,167
056080490208419706409050108000000000090030060680904015010602040700000003965803271,156387492238419756479256138341568927592731864687924315813672549724195683965843271,0.02290869998978451,41,609,568
027418590058679240000030000200000007080761030790000054001245800900000005805396401,327418596158679243469532718213954687584761932796823154631245879942187365875396421,0.01295300002675503,41,48,7
056034807000109203200078100080400005510390680090800001700085400000603708063041509,156234897478169253239578164382416975514397682697852341721985436945623718863741529,0.01459169998997822,41,142,101
146375802050109603300060000003590007610820040007410006900050000060904701784631905,146375892258149673379268514423596187615827349897413256931752468562984731784631925,0.01290489995153621,38,39,1
140235608000008507500070000210500906490061083670900405800040000000002701750319804,147235698362198547589476132213584976495761283678923415821647359934852761756319824,0.01504839997505769,41,161,120
100679284060100009070400000324000007005030400700000853000004070900001040842795006,153679284468152739279483165324518697685937421791246853516324978937861542842795316,0.01514030003454536,46,174,128
208345709059608230470010086302000908580090023000803000020000050905701602640030091,268345719159678234473219586312456978586197423794823165821964357935781642647532891,0.01395470002898946,39,76,37
107245609000369000400000005504826703090457010700903002001000900943000521070192060,137245689258369147469781235514826793392457816786913452621534978943678521875192364,0.01297119999071583,40,42,2
107264509000319000400000003001020700682070354700803001010000070520030016870192035,137264589258319647469587123341625798682971354795843261913456872524738916876192435,0.01334629999473691,41,66,25
107305209050196040060070080501234906490010053600000001000000000925040638800529004,147385269258196347369472185581234976492617853673958421714863592925741638836529714,0.01315839996095747,41,51,10
107238000058069001200000080601002508082596037503001604800000050025084006906715000,147238965358469271269157483671342598482596137593871624814623759725984316936715842,0.01304940000409260,40,46,6
136008050050069038400000020300050206892306015700080903500000070020013094974005060,136278459257469138489531627341957286892346715765182943513694872628713594974825361,0.01367259997641668,42,82,40
205139000060084009300500420400000706573016084900000103600700840020041005804623000,245139678167284539398567421412358796573916284986472153631795842729841365854623917,0.01388149999547750,42,93,51
200570903100230060300008502401002009090000030700100805604900008020017006807045001,246571983158239467379468512481352679592786134763194825614923758925817346837645291,0.01344209996750578,45,67,22
005206800020389010680050043201000705850000091900000008100734002502060907063925180,315246879427389516689157243231498765854672391976513428198734652542861937763925184,0.01310189999639988,40,51,11
408657100100030060000040705501004008380000047600700503803020000020070001006813902,438657129157239864269148735571364298382591647694782513813925476925476381746813952,0.01323699997738004,45,54,9
002358700030907010679020358305000901180000062200000003720583049000040000804792105,412358796538967214679124358345276981187439562296815473721583649953641827864792135,0.01350000000093132,40,53,13
008104300170098000439007080210000768380700592590000134821005040740086000005403800,658124379172398456439657281214539768386741592597862134821975643743286915965413827,0.01320250000571832,39,48,9
104008609360459200000007005500072004002000500900840002400900000005714083703500401,154238679367459218289167345531672894842391567976845132418923756625714983793586421,0.01363279996439815,45,78,33
270348609100569000000002058510400307480200061790800502000004095900785000650921804,275348619148569273369172458512496387483257961796813542821634795934785126657921834,0.01262850000057369,38,47,9
003589407500104300408007052120000906370200001980000205601002094700905600009641703,213589467567124389498367152124758936375296841986413275631872594742935618859641723,0.01411749998806044,39,102,63
000385409470096200300007016100600805750903024900500107500002048690031700000459301,261385479475196283389247516132674895758913624946528137513762948694831752827459361,0.01383950002491474,39,99,60
130450600200607013000002507300260805000000000504081002803900000920806004006013098,137458629258697413469132587371269845682345971594781362813924756925876134746513298,0.01592879998497665,45,198,153
200050008500109003070284050103745809000901000607823504702090305900010002050402070,241356798568179423379284156123745869485961237697823514712698345934517682856432971,0.01569189998554066,41,210,169
006020100100604003200109007410258076000000000705496201501040608900000004074965310,346527189197684523258139467413258976629371845785496231531742698962813754874965312,0.01312289998168126,42,62,20
230500400108307006509000018300068005000702000600150003820000604700205109004006032,236581497148397526579624318312468975495732861687159243821973654763245189954816732,0.01304380001965910,45,60,15
217450600308002047000000102100037809000000000705940001501000000840600705006025413,217459638358162947469378152124537869693281574785946321531794286842613795976825413,0.01396060001570731,45,84,39
150730000200109086309004500400380005060000020900012003001800709790605001000071042,156738294247159386389264517412386975563497128978512463621843759794625831835971642,0.01326439995318651,45,48,3
106080207400601008089000360310508096000106000507294803600040009700912004040763020,156389247473621958289457361312578496894136572567294813621845739735912684948763125,0.01332149998052046,40,61,21
208030605300209008070504020403695701000302000507841302700458006800010007060020010,248137695351269478679584123423695781186372549597841362712458936834916257965723814,0.01529549999395385,41,153,112
046030809208106004509400006400761908300904060600853201703500002904607003065010407,146235879278196354539478126452761938381924765697853241713549682924687513865312497,0.01361820002784953,37,60,23
045060802108209007209008506500682903700005060800713205407001609901806004082070301,345167892168259437279348516514682973723495168896713245437521689951836724682974351,0.01289800001541153,36,40,4
079100008500408009604309500100782405200604080400513706701906800900807001065200007,379125648512468379684379512136782495257694183498513726721936854943857261865241937,0.01295480004046112,39,42,3
048030005301009078609080003403605701180302040507801302702050006804006057065020004,248137695351269478679584123423695781186372549597841362712458936834916257965723814,0.01350649999221787,38,65,27
108000309260308057003409100312000798000702000700183005800030006600875001057621830,148257369269318457573469182312546798485792613796183245821934576634875921957621834,0.01283610000973567,39,42,3
417058003208400051309007204100000079500302410800000032601005807902600045745023006,417258963268439751359167284123584679576392418894716532631945827982671345745823196,0.01435409998521209,38,86,48
217305094300400026000008005502004001103920457604001003000003009700100042946702018,217365894358497126469218735572834961183926457694571283821643579735189642946752318,0.01332779997028410,40,68,28
054000380268040517070050020510000098607902103800615004000803000900020001030591040,154267389268349517379158426512734698647982153893615274421873965985426731736591842,0.01353120000567287,42,62,20
040008395300040006000030180500000068403617509690000003024060000700080002965700030,146278395358149276279536184512493768483617529697852413824361957731985642965724831,0.01518320001196116,46,173,127
256408193100000008308060207400305006507286904003947500001000300700000005980632041,256478193179523468348169257492315876517286934863947512621754389734891625985632741,0.01327879994641989,39,55,16
146008095300200006009005307630020009704953802590080004001006908800700001975004023,146378295357249186289165347638427519714953862592681734421536978863792451975814623,0.01351630000863224,40,89,49
148050792209107308070090040400000007305672904096504280001000400900000001650721039,148356792269147358573298146412839567385672914796514283821963475937485621654721839,0.01282930001616478,39,46,7
240019058100060002300208000480002903502196087690004105900605000700080006860043019,246319758158467392379258641481572963532196487697834125913625874724981536865743219,0.01290490000974387,40,47,7
030056008100000706068000104300000040724593681090000005601000870502000009900760010,437156298159248736268379154315682947724593681896417325641925873572831469983764512,0.01434429996879771,46,115,69
135270080200000057090008000802007590500601004064800703000700040640000002050012368,135274689286139457497568231812347596573691824964825713321786945648953172759412368,0.01298100000713021,45,57,12
137245689408109702060000050700000008680000071095708240003020800820000013076831420,137245689458169732269387154741652398682493571395718246513924867824576913976831425,0.01445230003446341,38,152,114
310857024400109006000206000160000089200601007795408613007000800000503000852764391,316857924428139576579246138164375289283691457795428613637912845941583762852764391,0.01326510001672432,39,48,9
130060059700000001000109000315080796420396085086705320500020007072000840803070502,138267459769548231254139678315482796427396185986715324541823967672951843893674512,0.02968549996148795,40,980,940
100030008300000005000608000501020709780905046093407510005070400426000857837564921,154239678368741295279658134541326789782915346693487512915872463426193857837564921,0.01424920000135899,39,125,86
290040018100208009000000000709000306500407001080903020601020805850090073974835162,295346718147258639368179254719582346523467981486913527631724895852691473974835162,0.01418860000558197,41,127,86
240050017100609003009104500410060098080503070003801600801030704064702130507010809,246358917158679243379124586415267398682593471793841652821935764964782135537416829,0.01289650000398979,39,49,10
340070291108904005209130087012000809080060000097000302701690048804705006960040173,346578291178924635259136487412357869583269714697481352721693548834715926965842173,0.01316899998346344,37,46,9
340060109051409608600107230010000907470690000080000403700903840034806705860040301,347268159251439678698157234512384967473691582986572413725913846134826795869745321,0.01337150001199916,39,63,24
037150860100206340400300050300580006580719003700460008600800090900601280045920630,237154869158296347469378152314582976586719423792463518621835794973641285845927631,0.01291300001321360,39,51,12
150040709027109400408500012002050804980620000004070603201400068035802100840010205,156243789327189456498567312762351894983624571514978623271435968635892147849716235,0.01339510001707822,39,83,44
360050190102093000500000000200309078400782005790405002000000009000970506054030021,367258194142693857589147263215369478436782915798415632671524389823971546954836721,0.01332770002773032,46,65,19
250030068604000109183000725300824006000070000000316000031090680040000050867040291,259137468674258139183469725315824976426975813798316542531792684942681357867543291,0.01308669999707490,43,45,2
254060738100307005000200000500402309640893001700605204000700000400901007937080412,254169738168347925379258146581472369642893571793615284815724693426931857937586412,0.01305790001060814,41,46,5
016340509407000000398060010180470006520091807760280004631050040802000000075830201,216348579457129683398567412183475926524691837769283154631952748842716395975834261,0.01565959997242317,39,152,113
147050269208106307300070008500000002490785036706000904020000090004507600870030021,147358269258196347369472518531964872492785136786213954623841795914527683875639421,0.01515690004453063,41,151,110
047050629008300701100000000510700006480090073900006058000000007705001300834070910,347158629258369741169247835512783496486592173973416258621934587795821364834675912,0.01357519999146461,46,75,29
045679230206008900000050007600703004750096102800205006000030009508004700031867420,145679238276348951389152647612783594753496182894215376427531869568924713931867425,0.01316229999065399,41,56,15
641278359307149208000050000100000006400090005906502403010000070003904500094020630,641278359357149268289356147125437896438691725976582413512863974763914582894725631,0.01320480002323166,42,43,1
254169738100040005300050006000402000042090570700615004810000093000000000937586412,254169738168347925379258146581472369642893571793615284815724693426931857937586412,0.01284570002462715,41,48,7
257168349408090702100070008070206090502030406600050003010000050900000007046985230,257168349468593712139472568371246895592831476684759123813627954925314687746985231,0.01488479995168746,41,164,123
305678201068000350200153004410000078600487005800912006020000080004806500086020740,345678291168249357279153864412365978693487125857912436521734689734896512986521743,0.01298279996262863,40,41,1
045670091000200007209003000010305008603080105800902030000700609700006000980021740,345678291168249357279153864412365978693487125857912436521734689734896512986521743,0.01309929997660220,46,51,5
206174009308005006400300001160500048583000120790800035800900004907006002601752003,256174389318295476479368251162537948583649127794821635825913764937486512641752893,0.01327989995479584,40,73,33
127356489500029300000400002200607095086090700700203064000800007900014600874965231,127356489548129376369478512213647895486591723795283164651832947932714658874965231,0.01315090002026409,37,44,7
315468927200009405070005000100000050053046209600000070020003000900004501847651392,315468927268179435479235168182397654753846219694512873521983746936724581847651392,0.01363250002032146,41,74,33
203468709100529008090000060340000076002090800980000032000030000027040680839756421,253468719176529348498317265341285976762193854985674132614832597527941683839756421,0.01551839994499460,41,178,137
200560380508000107300080065182000000453291076697000000700040098905000604800950730,214567389568329147379184265182476953453291876697835412721643598935718624846952731,0.01329900004202500,41,57,16
107368204400000003009000100312070859870090012090000060020030040003080600785246931,157368294468129573239457186312674859876593412594812367621935748943781625785246931,0.01302939996821806,41,52,11
204567309008000100079000260182000953050090070090805010000040000005708600846952731,214567389568329147379184265182476953453291876697835412721643598935718624846952731,0.01565980003215373,41,199,158
260073450500000003304500072005300007400090006800007300740002508900000004083950021,268173459579428163314569872125346987437895216896217345741632598952781634683954721,0.04464899998856708,46,1802,1756
107368209008000300203000106301070608740892031000000000002981400600040007014736950,157368249468129375293457186321574698746892531985613724572981463639245817814736952,0.01340529997833073,41,56,15
340915026108000309060000040401060207502080901000107000000050000700891003985634712,347915826158246379269378145431569287572483961896127534613752498724891653985634712,0.01323829998727888,41,50,9
000457000050000070679103425100000008800592004007814300020635040080020030365040291,213457689458269173679183425142376958836592714597814362921635847784921536365748291,0.01311250001890585,41,49,8
136040598008000700470508061300080007680000052090402080902371805000020000817050623,136247598258169734479538261324685917681793452795412386962371845543826179817954623,0.01377859996864572,40,89,49
200047580500000203340008701120500800407012056690700400810005904900000605700029130,261347589578196243349258761123564897487912356695783412812635974934871625756429138,0.01317960000596941,41,54,13
100250370008070006007100504001400007402090108900006400609005700700040800054037001,146258379598374216237169584361482957472593168985716432619825743723641895854937621,0.01418159995228052,46,123,77
207010309108000207340267015400020008580090073000805000000936000905080406030542090,257418369168359247349267815471623958582194673693875124714936582925781436836542791,0.01310330000706017,42,59,17
458030190000000508200180036340900705502301049980400301600570083000000604835090210,458736192163249578297185436341928765572361849986457321614572983729813654835694217,0.01529750000918284,39,201,162
250418060100050207300007805470600900502094073690800100700006502900080406830542090,257418369168359247349267815471623958582194673693875124714936582925781436836542791,0.01312550000147894,39,54,15
100239080350000702000500001400908507500070004701605008600002000804000056070416003,147239685358164792269587341436928517582371964791645238613852479824793156975416823,0.01972430001478642,46,420,374
240690130100000009070050062400300005583000726700005001620030080900000004054069013,245697138168423579379158462412376895583941726796285341621534987937812654854769213,0.03009989997372031,45,1091,1046
560090038407030205300000006130502089000080000896010523010000050700925001058671340,561297438487136295329458176134562789275389614896714523612843957743925861958671342,0.01461449998896569,41,135,94
205038070010400008090070102100003000573010246000200007601050080800007050050380604,265138479317492568498576132142763895573819246986245317621954783834627951759381624,0.02013520000036806,46,431,385
140378092278090631000010000400907005580060074690584023020000050000000000960721048,146378592278495631359216487412937865583162974697584123821643759734859216965721348,0.01396979996934533,41,84,43
140836090000009600060200400500007940480060017096400002001003050004500000030724068,147836295258149673369275481512387946483962517796451832821693754674518329935724168,0.02810480003245175,46,979,933
300251008158497263209030504500306009407000605960000082020000050700915006000762000,346251798158497263279638514512386479487129635963574182621843957734915826895762341,0.01394319999963045,40,94,54
054217096208359074070000000600700385500000769700800412010000000806973041037541028,354217896268359174179486253641792385582134769793865412415628937826973541937541628,0.01323049998609349,37,58,21
230479018108000709009080400300208005405090301600315007020804050800906004004751200,236479518148562739579183462317248695485697321692315847721834956853926174964751283,0.01313429995207116,40,50,10
140367098286040753007080100402601809060090070000000000010702080600804007708916405,145367298286149753397285164452671839861493572973528641514732986629854317738916425,0.01385139999911189,40,67,27
320040079158209643409050208201603907560090084890000026010000090000905000005461700,326148579158279643479356218241683957563792184897514326612837495734925861985461732,0.01324699999531731,39,42,3
106249008200601093000507000003700009804093265002400007000302000300904051905816002,136249578257681493489537126613725849874193265592468317761352984328974651945816732,0.01363800000399351,42,70,28
246537089100409060070000005000305098683090051000608032020000004800901020964752013,246537189158429367379186245412375698683294751795618432521863974837941526964752813,0.01361670001642779,39,67,28
154307089360000010200008653000439000600080395000526000800002534420000070937804062,154367289368295417279148653581439726642781395793526841816972534425613978937854162,0.01336819998687133,40,50,10
137408259050000030060537040040070090700050001590804023600040002000301000875692314,137468259458129637269537148341276895782953461596814723613745982924381576875692314,0.01303159998496994,40,71,31
207305619000200403300070250001600090400000006090001700014020007705009000936708504,247385619158296473369174258581647392473952186692831745814523967725469831936718524,0.01833839999744669,45,357,312
147306258050000070200080004071030890500010003000875000004050600720000089836749521,147396258358421976269587314471632895582914763693875142914258637725163489836749521,0.01378950005164370,41,63,22
016208390300100006200076040002000059403000207590000400020690004600007002075401680,716248395348159726259376148162734859483915267597862431821693574634587912975421683,0.01435670000500977,45,92,47
245109687160000439009000100010004070700081354050003060001000700530000248978302516,245139687167258439389476125613594872792681354854723961421865793536917248978342516,0.01610040001105517,39,202,163
147305600250060007009087020000000008406010503500000000070250300800090056005706812,147325689258961437369487125712534968496812573583679241671258394824193756935746812,0.04000719997566193,46,1497,1451
300105009410279056570060024000000000280090041607804205005406900900080002062951470,326145789418279356579368124154632897283597641697814235735426918941783562862951473,0.01485410000896081,40,150,110
716208095340050006000006000062034009400000007500860430000600000600080012970401683,716248395348159726259376148162734859483915267597862431821693574634587912975421683,0.01380549999885261,45,69,24
460308079170000006000067020006500098308000205740002600020780000900000017850901062,462318579173259486589467123216534798398176245745892631621783954934625817857941362,0.01287109998520464,45,54,9
496007813120040069500160000000680000305090187000570000600930000740010026859006431,496257813127348569538169274274681395365492187981573642612934758743815926859726431,0.01374040002701804,41,68,27
147305689250060007360480005010000900006002573080000200670250004820090006935706812,147325689258961437369487125712534968496812573583679241671258394824193756935746812,0.01797410001745448,38,347,309
206107408370040056010080030083902560504361702000804000801000609000608000760493021,256137498378249156419586237183972564594361782627854913831725649942618375765493821,0.01275180000811815,39,42,3
316708942207030506590060017000000000403605108080412060800000005000571000054823690,316758942247139586598264317162387459473695128985412763831946275629571834754823691,0.01399859995581210,40,117,77
320509078108070905570080021200305007403761802000408000702030504000000000065942710,326519478148273965579684321281395647493761852657428139712836594934157286865942713,0.01350470003671944,40,83,43
140203089000000704360008102400302060582097403600504020810005306000000201720901048,147253689258169734369478152471382965582697413693514827814725396935846271726931548,0.01334149995818734,40,64,24
346207001208000036100008500000405300400010007007603000001500008930000105800701423,346257891258149736179368542612475389483912657597683214721534968934826175865791423,0.01394879998406395,46,95,49
140205098008000301360080204400300900780052103500800700620090407004000509930701062,147235698258469371369187254412376985786952143593814726621598437874623519935741862,0.01305809995392337,41,51,10
107309508208010907360000024403257806500090002090604010600783009700000001980102073,147329568258416937369578124413257896576891342892634715621783459734965281985142673,0.01302979997126386,39,39,0
207300086100040039300000005001403900400186007003502400700000003820030004930004501,247359186158647239369218745581473962492186357673592418714965823825731694936824571,0.02067769999848679,46,524,478
103548679060100000509000004200400700380751206600800500806000007040300000701684923,123548679468179352579263184215496738384751296697832541836925417942317865751684923,0.01576879998901859,42,185,143
043509200700080090280000006000658900010293040006471000400000069070010004008704510,143569287765182493289347156324658971817293645956471328431825769572916834698734512,0.01461730001028627,46,125,79
500200948080140007304000002107408200250391406409705300703000004020610003900800125,571236948682149537394587612137468259258391476469725381713952864825614793946873125,0.01328600000124425,40,54,14
037500942400000030209030001000005190700392005096700000600040509070000004845006210,137568942458129736269437851324685197781392465596714328612843579973251684845976213,0.01372729998547584,46,49,3
230410908100009000400700002301007000870142069000500207500004003000900005906025041,237416958158239476469758132321697584875142369694583217512874693743961825986325741,0.01559389999601990,46,229,183
058267340060050020270498061000503000080679010507000206800000003900000004746135892,158267349469351728273498561614523987382679415597814236825946173931782654746135892,0.01340850000269711,40,78,38
047536280000070000360080057000000000403957602706208503001000900900020001835791426,147536289258179364369482157512364798483957612796218543621843975974625831835791426,0.01304859999800101,41,46,5
000100389350090100079008504000780006402615703000230001013002605720060900000900412,246157389358496127179328564531789246482615793697234851913842675724561938865973412,0.01450260001001880,42,132,90
047238560000000000069050120000326000030090040602000803010080070904613205026745390,147238569258169734369457128481326957735891642692574813513982476974613285826745391,0.01436680002370849,42,153,111
230184069000609000060375020014090680680050093005000400000060000703010806096040270,237184569158629347469375128314297685682451793975836412521768934743912856896543271,0.01310600002761930,44,67,23
230010098000000000068000250006587400402060307709302605000934000600020001094671530,235416798947258163168793254316587429452169387789342615521934876673825941894671532,0.01474750001216307,43,120,77
140030069000000000069457120080020050730090042600000003010982070970613085026040390,147238569258169734369457128481326957735891642692574813513982476974613285826745391,0.01595539995469153,42,213,171
140020068000109000069070520012586390870010045500000002000030000904050806085694210,147325968258169734369478521412586397873912645596743182621837459934251876785694213,0.01316590001806617,42,67,25
150467089006000700090050030004576900000030000900000007020613070608040102041982560,153467289286391745497258631314576928872139456965824317529613874638745192741982563,0.01407650002511218,44,123,79
247060518000000000060185070402090603080512040000000000000624000804903701936070425,247369518158247396369185274412798653683512947795436182571624839824953761936871425,0.01323709997814149,43,58,15
130406298406100000207358040800000300900061850500000600308714060601900000750602431,135476298486129573297358146862547319973261854514893627328714965641935782759682431,0.01349650003248826,40,70,30
136289574000000000490157062204060903305090406000010000001020800800901007960804051,136289574527346198498157362274568913315792486689413725741625839852931647963874251,0.01328809995902702,41,74,33
154000308060300009300405020501700903090000080703008201010902007900007010807000592,154269378268371459379485126581726943692143785743598261416952837925837614837614592,0.01657779997913167,45,227,182
130200409000190005259407000012000008500809006800000510000905784900081000705002093,137258469468193275259467831312576948574819326896324517621935784943781652785642193,0.02918000001227483,45,967,922
307100605100205079509008000270000006480506792690000003802003000700901058906800107,327194685168235479549678321271389546483516792695427813812753964734961258956842137,0.01931349997175857,42,378,336
306200100200104009109300254401000600680402593502000700704600935800901006903700800,346259187258174369179386254431597628687412593592863741714628935825931476963745812,0.01450209994800389,40,119,79
107500200200304609009008105603000904500603721701000306002006507800901402906400800,147569238258314679369728145623187954584693721791245386412836597835971462976452813,0.02752300002612174,41,917,876
105070308340000076609308201231060789000907000507000604012090560800706002904030807,125679348348251976679348251231465789486927135597183624712894563853716492964532817,0.01704580005025491,39,300,261
200459001150302069400106003310547098700000004804000507541803976000010000903705102,236459781158372469479186253312547698765298314894631527541823976627914835983765142,0.01889770000707358,38,388,350
040100009810309004509400610100000805300904001708000006051002908900806053600001040,246157389817369524539428617124673895365984271798215436451732968972846153683591742,0.01503539999248460,45,173,128
471293506050100009369000020104309600090600018607502900812000070030700002746825103,471293586258167349369458721124389657593674218687512934812936475935741862746825193,0.01340769999660552,37,44,7
100030008360109027009508400501302709782000135603000802815000976000906000906871204,154237698368149527279568413541382769782694135693715842815423976427956381936871254,0.01313330000266433,37,50,13
000060389300009040498000170100006508020030010907500003012000964040600001869050000,251467389376819245498325176134276598625938417987541623512783964743692851869154732,0.01674060005461797,46,240,194
240361095058020360009000100702906408000000000095782610521000784000807000806254901,247361895158429367369578142712936458683145279495782613521693784934817526876254931,0.01316840003710240,39,45,6
400050009286040357009267800100000004060090030895010276310000098600000002902781403,471358629286149357539267841123576984764892135895413276317624598648935712952781463,0.01361889997497201,41,81,40
400030009520070046093000720100000004050781090870090052041000960000607000765943218,417236589528179346693458721139562874254781693876394152341825967982617435765943218,0.01354269997682422,42,58,16
200040789400000000389000610120007508570000023608500047012000856000000002946050001,251346789467189235389275614123497568574618923698523147712934856835761492946852371,0.01487710000947118,45,148,103
200130409100000003300060580002306908080010040507402300021040005800000004906053002,258137469164598723379264581412376958683915247597482316721649835835721694946853172,0.01327490003313869,46,66,20
210345098307080406090206050000000000570090061980060042001050800000804000805637209,216345798357189426498276153164523987572498361983761542631952874729814635845637219,0.01466410001739860,43,118,75
100329008008060900360501072500402009400010005603807104714000356000000000836145297,147329568258764913369581472571432689482916735693857124714298356925673841836145297,0.01308649999555200,39,58,19
400210396168009002293060080300700009020190068800500001631020050782005004900670823,457218396168359472293467185316782549524193768879546231631824957782935614945671823,0.01296640001237392,38,50,12
350460290200000100070080005520608009100090002600201073700040080005000004046029031,351467298268935147479182365523678419187394652694251873712543986935816724846729531,0.01302989997202531,46,58,12
260070483310000009570340002100000900080090030007000005700052094800000057956030021,269175483314628579578349162123567948485291736697483215731852694842916357956734821,0.06030509999254718,46,2682,2636
310240580008009060009708124000001708190087036000002901001604895004003070970820410,317246589428159367569738124642391758195487236783562941231674895854913672976825413,0.02264899999136105,39,626,587
020050090406139205590268034000000000160090027049080360670010059000000000854020713,321457896486139275597268134235671948168394527749582361672813459913745682854926713,0.01657380000688136,42,225,183
030020090200000003460138027302070409780050016090301080021060970000080000976010835,137425698258697143469138527312876459784952316695341782821563974543789261976214835,0.01325499999802560,42,79,37
240378019100000008000156000003060900060893050095010640001934800600000004974080235,246378519157249368389156427713465982462893751895712643521934876638527194974681235,0.01320180000038818,42,66,24
210349086450000039060852040106070805080090020004010600001724900000605000805030402,217349586458167239369852741126473895783596124594218673631724958942685317875931462,0.01382709998870268,42,90,48
240009351150302809000000002012006905597810030083005704000000008830901507960007123,248679351156342879379158642412736985597814236683295714721563498834921567965487123,0.01279130001785234,39,46,7
138050794260407035500391006307040902080070040090000070700000009903802507856000423,138256794269487135574391286317648952682975341495123678721534869943862517856719423,0.01737940002931282,39,225,186
246007891100000003300068024000006310000020000097800000860470009700000005935600748,246357891158249673379168524482596317513724986697831452861475239724983165935612748,0.01407410000683740,46,126,80
158040379200307005400598001006179400080060090004805100000000000900684007847000536,158246379269317845473598621326179458581462793794835162612753984935684217847921536,0.01313209999352694,42,52,10
137050689200109037500070001070006004406510020050007006600020005700805063985030472,137452689248169537569378241371286954496513728852947316613724895724895163985631472,0.01297939999494702,40,50,10
053080120100402003200105006302746905006913200090000030800364007900000002647020318,453687129168492753279135846312746985586913274794258631821364597935871462647529318,0.01272779999999329,40,41,1
451020738270000049000457000100000006800236007060000020600348005730905082985060413,451629738276183549398457261123574896849236157567891324612348975734915682985762413,0.01351140002952889,40,42,2
007300801050209307300000040504062908600000003701580406010000009805907030906004100,247356891158249367369178245534762918682491573791583426413625789825917634976834152,0.01310590002685785,45,52,7
000367008300100057200095003691200004500780631783600009400036002800900045000542006,154367298369128457278495163691253784542789631783614529415836972826971345937542816,0.01375349995214492,41,114,73
108050007060308512000000308300840005590610284800590006000000809050901643903020001,138259467469378512275164398316842975597613284824597136641735829752981643983426751,0.01514470000984147,42,181,139
340506009000200067209000005000002803780154092905800000400000908570001000800407021,347516289158249367269378145614792853783154692925863714431625978572981436896437521,0.01411859999643639,46,115,69
300150802020400067500000000210045006480020075900360021000000008790004050804073009,347156892128439567569287134213745986486921375975368421631592748792814653854673219,0.01430079998681322,46,122,76
400030008210576049009000200100387005370090012906020407040000060650903081700861004,467239158218576349539418276124387695375694812986125437841752963652943781793861524,0.01322630001232028,41,74,33
371200009000519087000000100105370806290480705708950402000000600000124058954800001,371248569426519387589637124145372896293486715768951432812795643637124958954863271,0.01303279999410734,41,57,16
504317608060209010109000203806020904230000086407080301040000070700801009903475102,524317698368249517179658243816723954235194786497586321641932875752861439983475162,0.01360170001862571,39,103,64
300248009020519080509000104105372806200406005000000000010000040607104908954803271,371248569426519387589637124145372896293486715768951432812795643637124958954863271,0.01287490001413971,40,52,12
340056092000409067509200000210005000406000305000300021000002708790804000850670019,347156892128439567569287134213745986486921375975368421631592748792814653854673219,0.01325710001401603,45,62,17
253400107000508204000000000310006905620090071904700026000000000802901000709003512,253469187196578234478132659317286945625394871984715326531627498842951763769843512,0.02526640001451597,46,714,668
154267839000109207000000000400500900683092501700800300000000000000405602846923715,154267839368149257279358164412536978683792541795814326527681493931475682846923715,0.01325750001706183,42,54,12
137400082208070006640000000310500000705090803000007024000000095800020407590001268,137456982258179346649238751314582679725694813986317524472863195861925437593741268,0.01350289996480569,46,64,18
158346972200070003000108000402000509003090100590401026700050008800704001946000735,158346972264579813379128654412637589683295147597481326721953468835764291946812735,0.01288910000585020,41,41,0
435071982100050006000008003210503009006197008890406001000002005500010007983065214,435671982128359746679248153214583679356197428897426531741932865562814397983765214,0.01327850000234321,40,62,22
035481960100392008400000001000705000604020305050609020501000406700010002068254710,235481967176392548489567231312745689694128375857639124521873496743916852968254713,0.01424509997013956,42,107,65
354179268100283005000000000500010009613704852900000003400801006800060004769040381,354179268176283945298456137542318679613794852987625413425831796831967524769542381,0.01307340001221746,40,60,20
037048596100060004000500028300604000086917432700802000000700063600080009075026841,237148596158269374469573128312654987586917432794832615841795263623481759975326841,0.01279359997715801,41,54,13
158267349309415208070000050000000000786090532590602087600703005800000006040826010,158267349369415278472389651213578964786194532594632187621743895837951426945826713,0.01504410000052303,39,188,149
136248597400359008000000000000403000305000401890705032602901803900000006740536019,136248597427359168589167324261483975375692481894715632652971843913824756748536219,0.01318579999497160,40,59,19
236010579100000008000070000000204000542837196790060043600000004800359001025641830,236418579157923468489576312361294785542837196798165243613782954874359621925641837,0.01293450000230223,41,52,11
238146759107309608500070001000407000071692380000010000600905004700000003800734002,238146759147359628569278431352487916471692385986513247613925874724861593895734162,0.01347579999128357,42,73,31
410285697207000005500007014000006000376091842000002000600004078802000001750618423,413285697267149385598367214124836759376591842985472136631924578842753961759618423,0.01730160001898184,41,273,232
531246879402080503000070000000703000200891006390020015703000408000010000065437290,531246879472189563689375124146753982257891346398624715713962458924518637865437291,0.01329659996554255,42,57,15
045369107100008050000150006503000800017586923802000500000730008700001030038642705,245369187176428359389157246593274861417586923862913574621735498754891632938642715,0.01363449997734278,41,100,59
205369107006000300380050046003274800017586920000000000020030090000891000900642005,245369187176428359389157246593274861417586923862913574621735498754891632938642715,0.01327489997493103,44,56,12
351692408060100000070300020126000709000000000904000312010008030000001060805763241,351692478268147593479385126126834759537219684984576312612458937743921865895763241,0.01376360002905130,45,104,59
105040609000000000470508013094623150010805040806000307520080094043701860600492001,135247689268139475479568213794623158312875946856914327521386794943751862687492531,0.01283349998993799,39,39,0
301080204000000000480257063023060490000391000806000305000030000038715640705826901,351689274267143589489257163123568497574391826896472315612934758938715642745826931,0.01339019997976720,42,57,15
237460108100003000060187034601000905000504016405000703010925067700006000956740302,237469158148253679569187234681372945372594816495618723813925467724836591956741382,0.01284799998393282,39,40,1
347651002100000000069370004403000975070903240802000136021430009900000000785169003,347651892158294367269378514413826975576913248892547136621435789934782651785169423,0.01317310001468286,40,56,16
245360701100000040098174026003000052000591073001000094012847035700000060859620407,245369781167258349398174526973486152426591873581732694612847935734915268859623417,0.01411349995760247,38,102,64
105040609000139000400060003704623108000805000806000307001386700900701002680492031,135247689268139475479568213794623158312875946856914327521386794943751862687492531,0.01363659999333322,41,78,37
104237508000198000300050001601324807052801340800070006410000072520000083900040005,164237598275198634389456721691324857752861349843975216416583972527619483938742165,0.01348940003663301,41,72,31
204050608100060007006328400341080579000703000800000003000602000528931746907040102,234157698185469327796328451341286579652793814879514263413672985528931746967845132,0.01393179997103289,41,85,44
106040809000309000400000003302060508080102030690000021040000080963854712825731946,136245879258379164479618253312467598584192637697583421741926385963854712825731946,0.01311659999191761,39,43,4
234157008000009000700300450001000079050793010870000200013002005000900000900845132,234157698185469327796328451341286579652793814879514263413672985528931746967845132,0.01631289999932051,46,214,168
207419508000627000004000200010040070379162845400000001000804000703951602805070403,237419568958627134164583297512348976379162845486795321621834759743951682895276413,0.02099749998888001,41,490,449
146238759000060000009070600020080090670594083800000006000903000038706510764050932,146238759257169348389475621423687195671594283895312476512943867938726514764851932,0.01340549997985363,41,67,26
307261409000050000200070006129604578073185690500000001800702005000506000905813704,357261489618459237294378156129634578473185692586927341831742965742596813965813724,0.01436819997616112,40,156,116
251340607007000008400000130104080000070496050000020803016000002700000900508072316,251348697367159428489267135124583769873496251695721843916834572732615984548972316,0.01296869997167960,46,47,1
204078509070520004509004012300000807090287036800000405601005078040760003703092601,234178569176529384589634712312456897495287136867913425621345978948761253753892641,0.01305649999994785,39,52,13
107246509008050300009000200000020000302491605000583000020000090003762400764010823,137246589248159367659378214415627938382491675976583142521834796893762451764915823,0.01315489999251440,44,52,8
010050080208000307000070000180040076600080005004601800400905008905010203836724591,317452689248169357569378124182543976693287415754691832421935768975816243836724591,0.01311419997364283,43,55,12
010346080008000200509000306100080009086010520005624800600807002900030008874562193,217346985368159274549278316123785649486913527795624831631897452952431768874562193,0.01296689995797351,41,47,6
030010060106000304409050107300080002672000845805624701000000000020060070964735218,237418569156279384489356127341587692672193845895624731713842956528961473964735218,0.01338359998771921,41,65,24
200589601100000248360002000502008000400070009000200106000400057834000002905826004,247589631159637248368142795512968473486371529793254186621493857834715962975826314,0.01391909999074414,46,96,50
000358000208000107009000400400572008700090004006843700673080529010000070905736801,147358296258469137369217485431572968782691354596843712673184529814925673925736841,0.01452630001585931,43,136,93
107300860400000235039200004201000000390080041000000307800005710913000002056001903,127354869468197235539268174271643598395782641684519327842935716913876452756421983,0.02863800001796335,46,916,870
246508370150000600389160500000070804013900005000020703471850900920000400638209150,246598371157432689389167542562371894713984265894625713471853926925716438638249157,0.01326080004218966,39,55,16
001275600060000070079030120100080006430000017007010200610543098050020060984701532,341275689268194375579638124125387946436952817897416253612543798753829461984761532,0.01592289999825880,41,188,147
100254007040000030079368140320407068407000302000020000610705083700040009980632051,136254897548179236279368145325417968497586312861923574612795483753841629984632751,0.01677430002018809,40,244,204
107040509500000007349508216270403095401907302080000070602704908004050600030692040,127346589568129437349578216276413895451987362983265174612734958794851623835692741,0.01291740004671738,38,41,3
050030090200000007400507008345601879791000265800000003502403906683050741910070032,157238694268149357439567128345621879791384265826795413572413986683952741914876532,0.01556749996962026,38,199,161
140238070000000803309007004500002048060010090970800001400600902608000000020985016,146238579257149863389567124531792648862314795974856231415673982698421357723985416,0.01356759999180213,46,77,31
050137090300402007400000008140050089683000524700000001500208003824000675907645802,258137496369482157471569238142356789683791524795824361516278943824913675937645812,0.01396870001917705,40,100,60
030154080100000007400708001071080590680000074500000002803906405725301968946020713,237154689158269347469738251371482596682593174594617832813976425725341968946825713,0.01355129998410121,38,50,12
146038070050009003309507004000002008802000705900800000400603902600400050020980416,146238579257149863389567124531792648862314795974856231415673982698421357723985416,0.01450780004961416,45,146,101
145387060260000500009002001402050807703018640806070103001006004930000700678495010,145387269267149538389562471412653897793218645856974123521736984934821756678495312,0.01306550001027063,39,41,2
147389526008621400000000000000030000005106800980070041820050064700000005596714283,147389526358621479269547318612438957475196832983275641821953764734862195596714283,0.01274679997004569,41,53,12
307268159000000030500004060001080006403906502800020700010700004020000000734891605,347268159162579438589134267251387946473916582896425713618752394925643871734891625,0.01320309995207936,45,59,14
307246509240309067500070004400090003103000605706010802600407008000000000974865321,317246589248359167569178234485692713123784695796513842631427958852931476974865321,0.01286179997259751,40,47,7
106457298450000000009060050010020879605003401090010536001080040920000000807395162,136457298458239617279168354314526879685973421792814536561782943923641785847395162,0.01444070000434294,40,142,102
106237589200000000370480010010090003483700902090020008820910070900000000705842391,146237589258169437379485216512698743483751962697324158824913675931576824765842391,0.01251929998397827,41,54,13
301040608009178300070060020000090000500806002800020007602030705000902000945687231,351249678269178354478563129124795863537816942896324517682431795713952486945687231,0.01845840003807098,44,328,284
147035098050000300369070050010350009605802104080710006521080060030000900896043012,147235698258169347369478251412356879675892134983714526521987463734621985896543712,0.01307280000764877,39,46,7
200137008107000304098050270000070000403000806600304005721000659030060080860921037,246137598157289364398456271512678943473592816689314725721843659934765182865921437,0.01391860004514456,42,99,57
208369071070040203506170040010090007405000329090080004801630090050020806904851032,248369571179548263536172948312495687485716329697283154821637495753924816964851732,0.01388420001603663,38,107,69
206307089300000472079200160080500004503006728060900005035700840600000957807605031,216347589358169472479258163182573694593416728764982315935721846621834957847695231,0.01346170000033453,39,72,33
200367009300000006080040030037050260560010094002608300006000500040805070753426981,214367859375189426689542137137954268568213794492678315826791543941835672753426981,0.01439109997591004,42,47,5
350478069200000003000302000123506487700010006004000500802000305036921870947030621,351478269268159743479362158123596487785214936694783512812647395536921874947835621,0.01335459999972954,39,43,4
407008060002060004003407028230600905164090287750800603001904056005010002806003090,417238569582169374693457128238671945164395287759842613321984756945716832876523491,0.01322180003626272,40,49,9
257106839000000000030208050370802091081050320500000004000000000025931460946587213,257146839168395742439278156374862591681459327592713684813624975725931468946587213,0.01310539996484295,40,61,21
147250890360008070000300060230000600416930028790000300000400080670009010854720930,147256893362198475589374162235817649416935728798642351921463587673589214854721936,0.01453599997330457,42,143,101
261358490070100060508007000120000609030080245850000701302004000080600010746813950,261358497473129568598467123124735689637981245859246731312594876985672314746813952,0.01320079999277368,40,45,5
006471500000602000000000000002754900097080420680000015700040009843965271960217034,236471598158692347479538162312754986597186423684329715721843659843965271965217834,0.01316039997618645,41,53,12
240050018050209060060107050012030790400902005900010003800070009034801570795020831,247356918158249367369187254512438796473962185986715423821573649634891572795624831,0.01325920003000647,40,57,17
100269008000103000670000012421356897007000600000714000500030009013080260894020735,135269478248173956679548312421356897357892641986714523562437189713985264894621735,0.01307220000308007,41,50,9
008063279160000000203059068300000807002791034600000501704036052920000000005042716,458163279169278345273459168341625897582791634697384521714836952926517483835942716,0.01309010002296418,41,57,16
140038596250009300309000002400690800682000059700820600503000008920001700870056231,147238596258169374369547182431695827682713459795824613513472968926381745874956231,0.01355410000542179,40,82,42
306240580087005200000000004050030047603104902890070060200000000005800620068023705,316247589487915236529368174152639847673184952894572361231756498745891623968423715,0.01560729998163879,45,179,134
130426058208319406000000000300050007502080604006147200000000000043090780985060342,137426958258319476469578123314652897572983614896147235721834569643295781985761342,0.01342829997884110,42,48,6
300241000027089405008500003002050098800000007930020100200005900503910870000472001,365241789127389465498567213712654398854193627936728154271835946543916872689472531,0.03033259999938309,45,984,939
060379080178456239000000000380060057500000006090815020600000008023687540804030702,265379184178456239439128675381264957542793816796815423617542398923687541854931762,0.01274949999060482,41,42,1
060247080209308405400000002390070024501000703027934510900000008034020950708090201,165247389279318465483569172396175824541682793827934516912753648634821957758496231,0.01309269998455420,40,61,21
140238096208169304000000000431090827600000009005824600500000008026080740804050201,147238596258169374369547182431695827682713459795824613513472968926381745874956231,0.01456290000351146,41,140,99
010256030208147609000000000170060098300090006000718000700000005043925760956070423,419256837238147659567389214172463598384592176695718342721634985843925761956871423,0.01326729997526854,42,64,22
350281069002509300400000002214738956600000008078020140500000004040010020896050731,357281469162549387489367512214738956635194278978625143521873694743916825896452731,0.01267750002443790,40,41,1
140256093050070020000000000570000034403000902092030170800000005020618040936547281,147256893358179426269384517571892634483761952692435178814923765725618349936547281,0.01317180000478402,42,63,21
581000379032090840000000000100060004200804003047512690403000907020781030806439201,581246379632197845794358162158963724269874513347512698413625987925781436876439251,0.01344370003789663,40,43,3
365040289018050470400000005120406057500791003007523100001070800000000000746802591,365147289218359476479268315123486957584791623697523148951674832832915764746832591,0.01416469999821857,40,89,49
218050497069172380500000002180503029020090050095060830000020000900000003850934016,218356497469172385573489162186543729324897651795261834631725948942618573857934216,0.01601929997559637,41,220,179
040137080068040370300000002610000053450000096003615700000703000830020067796854231,245137689168249375379586412617492853452378196983615724521763948834921567796854231,0.01351570000406355,40,75,35
040209030358040279200000004010080090406513807073060410004000500030020060981605742,147259638358146279269378154512487396496513827873962415624791583735824961981635742,0.01290670002344996,40,47,7
205010306090020080300000004002306800503000602069040150700000008030971020954238761,245817396196423587387695214412356879573189642869742153721564938638971425954238761,0.01486729999305680,42,182,140
108076093060000020000300006090064570601507902087920040800002000020000060730840209,158276493369418725472359186293164578641587932587923641814692357925731864736845219,0.02624350000405684,45,833,788
347009082000270500000008007602000078403090605790000204800900000004081000970400851,347569182168274593259138467612345978483792615795816234821957346534681729976423851,0.02227560000028461,46,592,546
417206080508070042300400007000700008270000031800004000600003004940080103050901826,417236589568179342329458617135792468274865931896314275681523794942687153753941826,0.01523040002211928,45,166,121
100207005302010408570000031003705900405090307000823000700000003030681050856372149,148237695362519478579468231213745986485196327697823514721954863934681752856372149,0.01287259999662638,40,47,7
200137009167080423000000000410306078653010942090425030000000000030070060076802310,245137689167589423389264751412396578653718942798425136521643897834971265976852314,0.01264259999152273,42,46,4
000258000460070083500000007030000090246090875908040201091000740003010900854967312,317258469462179583589436127135782694246391875978645231691523748723814956854967312,0.01381500001298264,41,95,54
400356189109000007500000000300700594604015823800400671900000000208000005700839412,427356189169284357583197246312768594674915823895423671931542768248671935756839412,0.01450180000392720,42,151,109
207356108108090306300000007000603000586020731700080002800000005024010680670839014,247356198158297346369148527412673859586924731793581462831462975924715683675839214,0.01291039999341592,41,47,6
206300091048200007309040050400068000682093504700012000501020030027600005804900026,256387491148259367379146258413568972682793514795412683561824739927631845834975126,0.01306829997338355,42,69,27
230456018158020476460080053300208009504010807600000004000090000005060300840030092,237456918158329476469187253371248569594613827682975134713892645925764381846531792,0.01370310003403574,42,74,32
250360091067280004309040006500003000743016508800002000901030005078520003430790012,254367891167289354389145276512873469743916528896452137921634785678521943435798612,0.01291069999570027,40,46,6
305208609200050008498060125000506000807090203960000014001030900040080050780615032,315248679276159348498367125134526897857491263962873514521734986643982751789615432,0.01287560001946986,41,46,5
300248009206050308498000125130506097807090203900000004000734000040080050780010032,315248679276159348498367125134526897857491263962873514521734986643982751789615432,0.01299369998741895,41,47,6
216438009007250108500000000600080405403506812900020607700000000004960701169875004,216438579347259168598617243621783495473596812985124637752341986834962751169875324,0.01335199997993186,40,62,22
253647809000000274470002000300060095600905103700010068520006000000000687846791502,253647819168359274479182356312468795684975123795213468527836941931524687846791532,0.01381919998675585,40,80,40
201359478080100030703000050124005007300908601896001005407000080030700060602894713,261359478589147236743286159124635897375928641896471325417563982938712564652894713,0.01315549999708310,38,64,26
306200840020450760400800102013007580600523007097008230800900405040380690905700320,356271849128459763479836152213697584684523917597148236831962475742385691965714328,0.01289320003706962,38,42,4
057306029100000057200007000010005700570148032004700010000500008630000005740802390,457316829163289457289457163312695784576148932894723516921534678638971245745862391,0.01331000000936911,46,61,15
006305789430190056500000004000002005090418020800900000300000008750069013984701500,216345789438197256579286134143672895695418327827953641361524978752869413984731562,0.01334509998559952,44,84,40
300209750460050832000000106006000980240398560005000240000000408750040619900706320,318269754469157832572483196136524987247398561895671243621935478753842619984716325,0.01446690002921969,42,149,107
100047809000000420400308000030070198600924003795010040000702004067000000802650001,156247839378195426429368517234576198681924753795813642513782964967431285842659371,0.01635829999577254,46,265,219
401030709302090406500408003614302895720080064030050010000503000073010540050709030,461235789382197456597468123614372895725981364839654217146523978973816542258749631,0.01303169998573139,40,42,2
240030089150070024300208005400306007605090203093821450000000000930784062070502030,247135689158679324369248175412356897685497213793821456526913748931784562874562931,0.01388340000994503,40,72,32
105389706006000500200507003450603097001000300063070250017020630024030970809706402,145389726376142589298567143452613897781295364963478251517924638624831975839756412,0.01293239998631179,39,62,23
157040368308000402400308001270080039080000040094713820700534006035020710000901000,157249368368157492429368571271485639583692147694713825712534986935826714846971253,0.01288970001041889,40,41,1
247090186058000430300108007470080065000901000003070800800562003920734018006809500,247395186158627439369148257471283965682951374593476821814562793925734618736819542,0.01303189998725429,40,47,7
105678209000000000208504607400090003003801900080362040600050008014020750709486301,145678239376219584298534617421795863563841972987362145632157498814923756759486321,0.01400710002053529,41,98,57
100249308000100002409300001201085039080602147604013025702500006000800004800971203,157249368368157492429368571271485639583692147694713825712534986935826714846971253,0.01348740002140403,39,53,14
260000038000802000380070015410000097090705040003149600540203076800010004907654801,264591738175832469389476215412368597698725143753149682541283976826917354937654821,0.01353699999162927,41,64,23
231050798057108460400000001000609000670201039009040600510803046040060080806514307,231456798957128463468397251125639874674281539389745612512873946743962185896514327,0.01387770002475008,39,61,22
307054089000069037600300024700543000000000000000712003460001005970820000180470206,317254689248169537659387124721543968534698712896712453462931875975826341183475296,0.01351469999644905,45,62,17
305217408000000035109050006402063000000902000000180203600030907930000000804729301,365217498278496135149358726412563879583972614796184253621835947937641582854729361,0.01377229997888207,45,75,30
204009005000080029300100047510648000040201060000753014420007006970060000600900802,264379185157486329389125647512648793743291568896753214421837956978562431635914872,0.01370519999181852,45,66,21
250369078000000000370102094080643020642090853000080000400000007026000940937814562,254369178169478235378152694581643729642791853793285416415926387826537941937814562,0.01296299998648465,40,53,13
371459028000023497200000000003076000029508743005094000400000000000041572957682014,371459628568123497294867135143276859629518743785394261412735986836941572957682314,0.01324649999151006,40,65,25
065217098208000035000050006402063009583900014706084003000030007907000082054729061,365217498278496135149358726412563879583972614796184253621835947937641582854729361,0.01303939998615533,39,53,14
009178243102000089000000007206037805357890020908012706000000008704000052005724361,569178243172345689483269517216437895357896124948512736621953478734681952895724361,0.01316129998303950,39,48,9
200501008100497006070020050001070200400010009093080540000208000904103807835769412,246531798158497326379826154561974283482315679793682541617248935924153867835769412,0.01341730001149699,41,75,34
240305600108000432000080105000036008600509003500870000704020000925000807006704021,247315689158697432369482175471236598682549713593871264714928356925163847836754921,0.01299159997142851,45,53,8
006209587208107300009080000002060908680790205003050401001070000805406700007503842,146239587258147396379685124512364978684791235793852461421978653835426719967513842,0.01309570000739768,41,65,24
020306490138209507040070010400000003075931600900000001050060030392807106060103270,527316498138249567649578312416785923275931684983624751751462839392857146864193275,0.01533710001967847,41,135,94
000307000309020407478050312100000008000702000697010523010273080700080004806495201,251347896369128457478956312142539768583762149697814523914273685725681934836495271,0.01316259999293834,41,77,36
060307040209468301504000608000000000400702006697010423001070800700986002806241907,168357249279468351534129678312694785485732196697815423921573864743986512856241937,0.01352079998468980,40,75,35
230508019015030260800010004900374005400105007587602431000726000300000006609040102,234568719715439268896217354921374685463185927587692431148726593372951846659843172,0.01487270003417507,40,52,12
100200060250069704069078102520000006480502309790000005072041503810053607900700040,147235968258169734369478152521397486486512379793684215672841593814953627935726841,0.01367679995018989,39,63,24
247108000300400007109300500700000859400205001596000002001003908900007005000906143,247158396358469217169372584712634859483295761596781432621543978934817625875926143,0.01339629996800795,45,88,43
158200006009080107403060002300490005004000600700053009800030704605070900900001863,158247396269385147473169582316498275594712638782653419821936754635874921947521863,0.01609320001443848,45,200,155
467209358100080009598000124010000090300108002906030705800060007003020900709841206,467219358132584679598376124214657893375198462986432715821963547643725981759841236,0.01348559994949028,40,93,53
317408962208000503509000408120070095604000107005020600800942006002010300900503001,317458962248169573569237418123674895684395127795821634831942756452716389976583241,0.01312800002051517,41,56,15
217348956000060000409207108070000060504080301006090500601904805003070200740801093,217348956358169742469257138872513469594786321136492587621934875983675214745821693,0.01420909998705611,40,102,62
210300098007090400400000310600070050804915203090080004032000007005020900960001042,216354798357198426489267315621473859874915263593682174132549687745826931968731542,0.01550270000007004,46,190,144
150368079006109500009070100510080094603412807000050000000706000700524001460000023,154368279276149538389275146512687394693412857847953612921736485738524961465891723,0.01678890001494437,43,249,206
200408009108069000069000008380070014514392706970010032021000005703085000800601003,237458169158269347469137258382576914514392786976814532621743895743985621895621473,0.01331250002840534,41,57,16
260147059070309080000000000020406030300792001609010702900604008700020004846070123,268147359471359286593268417127486935354792861689513742912634578735821694846975123,0.01469109999015927,42,154,112
340018009000309148189000200710090002800154607690020004431000700000506481560041003,346218579257369148189475236714693852823154697695827314431982765972536481568741923,0.01308459998108447,39,55,16
140206039068104520270000046080060010601020308700901004814030692500010003900040001,145276839368194527279358146482763915691425378753981264814537692527619483936842751,0.01404750003712252,40,121,81
100479068060100507200060403014005000700000005000700320501080004903001080680342001,135479268468123597279568413314295876792836145856714329521987634943651782687342951,0.01489610003773123,45,122,77
200583017170000504309100000002300000500219008000006100000004809704000061980621003,246583917178962534359147682412358796567219348893476125621734859734895261985621473,0.01321920001646504,46,56,10
106258903057000260200060001030572090700496005000000000570020089609080402020931050,146258973357149268298367541431572896782496315965813724573624189619785432824931657,0.01290789997437969,42,43,1
140235690302009048000486002200347000437000006900612000000854009703001064890763250,148235697362179548579486312216347985437598126985612473621854739753921864894763251,0.01338869996834546,37,61,24
051437980068000140400168005016000490800000001900814002700040003690080014040672050,251437986368259147479168235516723498824596371937814562785941623692385714143672859,0.01357789995381609,41,77,36
005006147040000009009107008076480000402070506000012470700503800800000020964800700,285936147147258369639147258376485912412379586598612473721563894853794621964821735,0.01315970002906397,46,72,26
235798106008000239400003508000860000640100023000930000500007904004000765867549302,235798146178456239496213578351862497649175823782934651513627984924381765867549312,0.01318349997745827,40,44,4
106358090500000108008017063300500009060800700705604001400900806002085000003146950,126358497537469128948217563314572689269831745785694231451923876692785314873146952,0.01320720004150644,43,85,42
146357280000000063308400700010030807080071640700000000601000000900008506875290310,146357289257189463398462751412635897583971642769824135621543978934718526875296314,0.01656100002583116,44,251,207
316240708480000053509308004030400500600000029708500001050010300004000015103007002,316245798487196253529378164231489576645731829798562431952614387874923615163857942,0.03810780000640079,45,1413,1368
137480600008070010400102508300050090084093000700806203020040000000001002576920400,137485629258679314469132578312754896684293157795816243821347965943561782576928431,0.01350589998764917,45,64,19
357008269060050730409000005270000403003090070600307000010930000005026001900070308,357148269168259734429763815271685493583492176694317582812934657735826941946571328,0.01394330000039190,46,95,49
157300200000510000309200401000450890500000074790100005830000000000001048645892700,157364289428519637369278451213457896586923174794186325831745962972631548645892713,0.02900959999533370,46,994,948
007300109000049020000200403410560800680001000700804001530980674000617008870405902,247356189358149726169278453412563897683791245795824361531982674924617538876435912,0.01592179998988286,42,218,176
100300509000070040004200003400020800807000030263007001610030980005091026970502304,126348579539176248784259163451623897897415632263987451612734985345891726978562314,0.03528400004142895,45,1416,1371
140000300376080050098300601710400503050070040900000807420000900501000086089703104,145267398376189452298345671712498563853671249964532817427816935531924786689753124,0.01426939998054877,44,122,78
310200790080090050009008164200400000045730029708500001950010300004000015163807002,316245798487196253529378164231489576645731829798562431952614387874923615163857942,0.01365340000484139,43,88,45
100368209070000800009407016720506100060070040504001007010700900008090721900802003,145368279376129854289457316723546198861973542594281637612734985438695721957812463,0.01569380000000820,44,212,168
300156409000230607009007012200604000080970200604008075000860504000001063906043001,327156489418239657569487312275614938183975246694328175731862594842591763956743821,0.01351910002995282,43,90,47
200040903060200504071093068120609705090310000600005009010700806705000400800001007,258146973369278514471593268123689745594317682687425139912734856735862491846951327,0.01319610001519322,45,62,17
107008069000100200209040051400503002080710006003804005704030008010000003005002614,147258369358196247269347851471563982582719436693824175724631598916485723835972614,0.01442040002439171,46,138,92
200703409360050200009000053120306705030090000900504001610800907700040080005002306,258713469361459278479268153124386795536197824987524631612835947793641582845972316,0.01722059998428449,45,345,300
350408792270900600009030051500100908080070000607002004710600409800090020006001037,351468792278915643469237851523146978184379265697582314712653489835794126946821537,0.01287820003926754,44,51,7
150008403400030520380009067270310005040090000503006004600900802005040000038605001,157268493469137528382459167276314985841592376593786214614973852725841639938625741,0.01281260000541806,45,73,28
358207009100050380470001050200500008080070030706003405800000004000020060635104072,358267149162459387479381256213546798584972631796813425827635914941728563635194872,0.01397420000284910,45,78,33
100208309480350100050060040200000003730690480048703062570020904000070020004005817,167248359482359176359167248216584793735692481948713562571826934893471625624935817,0.01356469996972010,42,63,21
100204368320100000069038070200600000070380000900002043630900804040010900805063712,157294368328176495469538271213649587574381629986752143631927854742815936895463712,0.01396350003778934,43,101,58
547109208100000507060000040200003004470500800800427315680700009030000100904001723,547169238129348567368275941215893674473516892896427315681732459732954186954681723,0.01850910001667216,43,366,323
007049065200100703560070140402097000003400900705000080000006008020010500904053621,137249865248165793569378142482597316613482957795631284351926478826714539974853621,0.01335220003966242,45,75,30
107238059300100400200050080502000008476000300003002046600500804700900205085620731,147238659358169427269457183512346978476895312893712546621573894734981265985624731,0.01355679996777326,42,88,46
108507029000000407470030051003085096500000000600900040701094005840016900036052174,168547329352169487479238651213485796594673218687921543721394865845716932936852174,0.01604299998143688,42,234,192
006007095108600403300580026407008009000100700005070061001002007030940600984050012,246317895158629473379584126417268539623195784895473261561832947732941658984756312,0.01321750000352040,44,58,14
407085093100300007500070410001008065306051708005900000600503009030000100052807634,467185293129346587583279416241738965396451728875962341614523879738694152952817634,0.02604319999227300,43,774,731
207038069000200437060400280071000005400500600805970000702603058904800700080790014,247138569158269437369457281671324895493581672825976143712643958934815726586792314,0.01315339998109266,42,52,10
305079218260300705100250406001007009602000007000080000500702003800900500937840020,345679218268314795179258436481527369652193847793486152514762983826931574937845621,0.01397849997738376,44,97,53
003409067400100082000270004005008010164900008790010000600004025847305600000860070,213489567476153982589276134325648719164937258798512346631794825847325691952861473,0.01346909999847412,45,67,22
305001096000309402200050100001000008400108905096740020608907034720500000054860010,345271896167389452289456173531692748472138965896745321618927534723514689954863217,0.01310199999716133,43,51,8
206048759007009208580070100362007090000600002010020500601004005790005600050060317,236148759147359268589276143362587491475691832918423576621734985793815624854962317,0.01364200003445148,43,83,40
138000079007508061560130008001025090400600103090080020800002004704900600010800732,138246579247598361569137248371425896482679153695381427853762914724913685916854732,0.01413970004068688,43,105,62
247300091000209006360000500003001060600700105001620000402007008930800400070514230,247356891158249376369178524593481762624793185781625943412937658935862417876514239,0.01340609998442233,45,72,27
007230498000169007530087100040010070300500801090600000602003785700001004984000310,167235498428169537539487126245318679376592841891674253612943785753821964984756312,0.01380839996272698,43,95,52
007030680308109502560700000120046090406000305780000100001000058052600000874500061,217435689348169572569728413125346897496817325783952146631274958952681734874593261,0.01383329997770488,44,85,41
107050380008000007300408100000060000605809013000030450021083094730010002890700501,147256389258391647369478125413562978675849213982137456521683794734915862896724531,0.01310859998920932,45,59,14
047350100000002079300108200010020000602700031090015604800007406400906002900040800,247359168158462379369178245514623987682794531793815624821537496435986712976241853,0.01261709997197613,46,49,3
007256080058001047300400105010060070600809003900100400001080000730915000806700531,147256389258391647369478125413562978675849213982137456521683794734915862896724531,0.01433669996913522,44,119,75
108040090004159078300260000010070000903006005080900200031020080840001003690800124,158347692264159378379268451416572839923486715785913246531624987842791563697835124,0.01349939999636263,45,84,39
317058460008039057509400300000040800280601034600000005001075042700906000850300900,317258469468139257529467318173542896285691734694783125931875642742916583856324971,0.01299349998589605,43,50,7
207359160008002079300170200014020080602704001700000604021000006030906002970200803,247359168158462379369178245514623987682794531793815624821537496435986712976241853,0.01558970002224669,42,189,147
018046070007009082560200104370080000105003207040000003051002008000004005790800301,218346579437159682569278134372481956185693247946527813651732498823914765794865321,0.01305929996306077,46,57,11
005060380008029016300108007013290750586700003090000104002840005000002000870605902,125467389748329516369158427413296758586714293297583164932841675654972831871635942,0.01308140001492575,43,73,30
007050280308092076260100405470030090502901007600000502700020000000703004830600700,147356289358492176269187435471235698582961347693874512714528963926713854835649721,0.01511370000662282,45,176,131
375028400000000038100306000040070850607004003810200600000763004004802005780000301,375128496462597138198346572243671859657984213819235647521763984934812765786459321,0.01556119997985661,46,162,116
348090276002007490500204008010040709003900042097800001020030000004018020750009013,348195276162387495579264138215643789683971542497852361821736954934518627756429813,0.01390979997813702,43,93,50
158370600060000040009002003320700098004021006000000001030010900045006087716049002,158374629263198745479652813321765498584921376697483251832517964945236187716849532,0.01357599999755621,46,77,31
146230590200000047379008602000010000400090080805706003020001800007004035684305071,146237598258169347379458612762813459431592786895746123523971864917684235684325971,0.01391869998769835,42,82,40
007130508158240060309057002010070809500003000703400005020764900004008020900300486,247136598158249367369857142412675839586913274793482615821764953634598721975321486,0.01489059999585152,42,155,113
100250369300090070609300108210080500504020080800009002481000000030005046905703801,147258369358691274629374158213486597594127683876539412481962735732815946965743821,0.01706919999560341,43,253,210
250100409360000002479008501120090700084030016007004005000000000005006087746501003,258167439361459872479328561123695748584732916697814325812973654935246187746581293,0.01356649998342618,45,84,39
400100692030060000208009003670300805002070010004601007010000000025006034906750201,457138692139267458268549173671392845382475916594681327713824569825916734946753281,0.01415449997875839,46,133,87
130200607000000348409000005390601574602480030700005002020000000073006020906802703,135248697267159348489763215398621574652487139714935862521374986873596421946812753,0.01458809996256605,44,134,90
130420597457010000000000008310600009006190040800703002620000000003005021905261304,138426597457819236269537418312648759576192843894753162621374985743985621985261374,0.01353210001252592,44,71,27
400200701020049000500000032060008570000090048804702103910070300708003025603820917,436285791127349856589167432261438579375691248894752163912576384748913625653824917,0.01353529997868463,42,54,12
210300509050000420000008173020000005006081034000503001030840900042035010705619042,217364589358197426469258173123476895576981234894523761631842957942735618785619342,0.01378889998886734,43,86,43
200301690060089040300006002500100800610098037708603001070960500052004010906800024,245371698167289345389456172523147869614598237798623451471962583852734916936815724,0.01365649997023866,42,72,30
300170205720000609100000004230400900000080123007002006510690807003001060604725091,346179285728534619159268734231456978465987123897312456512693847973841562684725391,0.01653560000704601,43,231,188
300108260100000070400250081200476008086090020790502003030000900002005036805903142,357148269128639475469257381213476598586391724794582613631824957942715836875963142,0.01325509999878705,42,54,12
200136589150000600000070200401785096080040050700001002004800000036010928802000431,247136589158294673369578214421785396683942157795361842914823765536417928872659431,0.01734950003447011,43,266,223
247139056100064309000050002503901024080520007600003001900305000725000010806000005,247139856158264379369857142573981624481526937692743581914375268725698413836412795,0.01376490003895015,43,80,37
240308509130000406800060070300207905070090600000004007700900802920050761005002094,246378519137529486859461273361287945472195638598634127713946852924853761685712394,0.01389359997119755,44,99,55
230100098400080307000070020103000000070500810805013046310900400900860730008000062,237154698461289357589376124123648579674592813895713246316927485942865731758431962,0.02316460001748055,46,628,582
258000076160000300000096080400007005010400038003085002500900007830710509907002060,258341976169278354374596281482137695615429738793685412521963847836714529947852163,0.01463049999438226,46,140,94
372140009180200304400050000003001005000690200809027036500700000640030700007815042,372146589185279364496358127263481975754693218819527436521764893648932751937815642,0.01315470004919916,44,49,5
246007009100200300370168040402003608000000000097012004601705003720800006905020080,246357819158249367379168245412573698563984172897612534681795423724831956935426781,0.01377230003708974,44,80,36
300406009200100607000070001102004003680510000005087006700605408930800765006040130,317456829248193657569278341172964583683512974495387216721635498934821765856749132,0.01371579995611683,44,85,41
208307506600590100009160270140603809763080000000020007400200905501009040006800021,218347596674592183359168274142673859763985412895421367487216935521739648936854721,0.01381929998751730,42,88,46
107049086200100409000580001302705008000000000004031007923400005740900060605072090,137249586258167439469583721312795648576824913894631257923416875741958362685372194,0.01459359994623810,45,141,96
201307806300009500000068040003004905000500023095000084010800009034706008056000031,241357896368429517579168342123684975487591623695273184712835469934716258856942731,0.01511039998149499,46,188,142
256000089100500006000080000312008705500000308000065042600903074037800001005071920,256137489178549236493286517312498765564712398789365142621953874937824651845671923,0.02615150000201538,45,847,802
105006089270100300080050000007008062500004801028015003701900008960800400004061090,145236789276189354389457126417398562593624871628715943751942638962873415834561297,0.01467489998321980,45,158,113
137204509200170300400085010000000001310000608792016035021400053003500006805000040,137264589258179364469385217586943721314752698792816435621497853943528176875631942,0.01712410000618547,43,286,243
147000085250009706060070000000300679003400002086090041030804007020000500705023418,147236985258149736369578124412385679973461852586792341631854297824917563795623418,0.01479079999262467,44,120,76
056008293100025708200030050001007049500100607004090032000950004820300900047061020,456718293139425768278639451361287549592143687784596132613952874825374916947861325,0.01314799999818206,43,46,3
007036085200009006000070100012080079900400002006000041601800007820000500795623418,147236985258149736369578124412385679973461852586792341631854297824917563795623418,0.01338680001208559,44,62,18
007005869100009407060080000001020083000900206690070054004002008820700600930041720,247135869158269437369487512471526983583914276692378154714652398825793641936841725,0.01274379994720221,45,55,10
000008069300100802200300740400082607706401003009030000001804006000006504670950020,145278369367149852298365741413582697756491283829637415531824976982716534674953128,0.01415359997190535,46,89,43
007008061100009304060070000012000057700500109985010032501406003670900500890035210,247358961158269374369174825412893657736542189985617432521486793673921548894735216,0.01362440001685172,42,73,31
000108029300009006190270000006000080405800001930500064001000005703905600859020743,567138429382459176194276358216394587475862931938517264621743895743985612859621743,0.02140470000449568,45,533,488
007348096500100003000050041401070059300005607060910002003001000200506700900030125,127348596548169273639257841481672359392485617765913482853721964214596738976834125,0.01400319999083877,45,107,62
206400019107309048000127005700000000800000506090780102301005090970602400560070820,236458719157369248489127365712536984843291576695784132321845697978612453564973821,0.01612380001461133,43,221,178
047006098108009076060080400002090040800605002090270500001050000600802000780964231,247536198158429376369187425512398647873645912496271583921753864634812759785964231,0.02244430000428110,44,580,536
000040098008009760060500042070680005502407306680290000801730009900801000040950801,217346598458129763369578142174683925592417386683295417821734659935861274746952831,0.01428010000381619,43,132,89
050000379300100245407300008010040690604507003730810002105000034900600001040000706,251468379386179245497325168518243697624597813739816452165782934972634581843951726,0.01349859999027103,44,86,42
040050098300009017200108403001090080602001509090080100063000000904805000520006801,146357298358429617279168453431592786682741539795683124863214975914875362527936841,0.01879119995282963,46,381,335
010320598200596047500100000042070800603005072790004613000000004900000005050700301,416327598238596147579148236142673859683915472795284613327851964961432785854769321,0.01341419998789206,45,80,35
000056398008009047300470105501040060406003002070090403003002054700501006980000200,247156398158329647369478125531247869496813572872695413613982754724531986985764231,0.01434539997717366,44,137,93
140230987000070060300008000010040000024001008803600405002900871900702003780300200,146235987258179364379468152517843629624591738893627415432956871961782543785314296,0.01515389996347949,46,155,109
358170629009030070400506000010040907600017003500002100020053000805009041900700502,358174629169238475472596318213845967684917253597362184721453896835629741946781532,0.01385180000215769,44,89,45
060180394407320080900406002020030760000001005800004210001060030002003057700800600,265187394417329586938456172124538769376291845859674213541762938682913457793845621,0.01370870001846924,46,79,33
040350809208000070300200005431020000002903068000005200700000984604001003890734600,147356829258149376369287145431628597572913468986475231713562984624891753895734612,0.01610519998939708,45,202,157
410350802208090050500408007172043000304001075090000300021030904900004008740200500,417356892238197456569428137172543689384961275695872341821735964953614728746289513,0.01459199999226257,43,74,31
540820309000079040300105000180050600003060002690000003700002980905601004836790500,541826379268379145379145268182453697453967812697218453714532986925681734836794521,0.01429110002936795,44,113,69
140530209200060073360001005410053700000004002800020354000040907004002036730800400,147538269258469173369271845412653798573984612896127354621345987984712536735896421,0.01386970002204180,44,84,40
040260305000080090300407002410020600006005004708340251070000900900804006854600703,147269385562183497389457162415728639236915874798346251671532948923874516854691723,0.01344969996716827,44,70,26
030270904007090050500406002410060528005001093080000107000050000704002001860307205,136275984247198356598436712413769528675821493982543167321654879754982631869317245,0.01401179999811575,45,98,53
230548197000000020150206003010080700005307008700602300500060000903004001680750932,236548197847139526159276483312485769465397218798612345521963874973824651684751932,0.01423179998528212,43,137,94
147060090300109006069078000000003087800400903090080040901007054400010870786004039,147265398358149726269378415514693287872451963693782541921837654435916872786524139,0.02362580003682524,43,706,663
240710308000000740009408002010380400000024001800590200020030000907006025680972100,246719358158263749379458612512387496793624581864591273421835967937146825685972134,0.01474600000074133,45,179,134
240130609068270400000408000400080063302050001600041270000000800004003057956807004,247135689168279435539468712471982563382756941695341278713524896824693157956817324,0.01507189997937530,44,148,104
251463709060070200009508030000080400000000023600004008902050804735800062806000001,251463789368179245479528136123685497584917623697234518912356874735841962846792351,0.02842230000533164,45,920,875
305678402700120000000005087020000000030080014009007035670830509903054021104000003,315678492748129356296345187421593768537286914869417235672831549983754621154962873,0.01536670001223683,44,179,135
300256709069070000572004006230060508456000000807003000013720000904000057700640001,348256719169378245572194836231467598456982173897513462613725984924831657785649321,0.01409640000201762,44,96,52
250307000430060020600258001100506080080090314307004002810000549703005060900000003,251347896438169725679258431124536987586792314397814652812673549743925168965481273,0.01303440000629053,44,47,3
305208700027690000400007026270000604080000070904006038510830460702000080806901003,365248719127693845498157326271385694683419572954726138519832467732564981846971253,0.01650690002134070,43,246,203
250104609376520100400008025100000000080000517700001063830010940501060030900800701,258134679376529184419678325123756498684392517795481263837215946541967832962843751,0.02556360000744462,43,773,730
350200700000090050470008020200005008687012034590004071740800305002000047830009002,356241789128397456479568123214735968687912534593684271741826395962153847835479612,0.01330859999870881,44,56,12
204300609060149000000200034400680000820091705006003002700805406000010087948006051,214358679367149528589267134475682913823491765196573842731825496652914387948736251,0.01348700001835823,43,57,14
251308007060100003300060040100780506570093401680000072700020650825000010900001038,251348967467159823398267145134782596572693481689415372713824659825936714946571238,0.01537239999743178,42,43,1
210309056450100020000050019300006004740000105506002003120600807830000040967004031,218349756459167328673258419391576284742983165586412973124635897835791642967824531,0.01795720000518486,43,144,101
914006007350100204608030090100600009240090500009004003400800906000040030893065410,914256387357189264628437195135672849246398571789514623471823956562941738893765412,0.01385799999115989,44,98,54
107068009000100000209057010300800004080270900604003072710900506000030090946085020,157368249468129735239457618372896154581274963694513872713942586825631497946785321,0.01853170001413673,45,352,307
201007609468130000000000030300604908020090700007005003100903507000010000786500391,231457689468139275579268134315674928824391756697825413142983567953716842786542391,0.01367909996770322,46,83,37
300046008408100300000070024000502007090780401003000002600904785970010003845007019,317246598428159376569378124184562937296783451753491862631924785972815643845637219,0.01328259997535497,44,51,7
405008209120300500000056040200003097750000600084017002500820004800000020692034015,465178239128349576379256148216583497753492681984617352537821964841965723692734815,0.01536069996654987,44,178,134
107246009200300000060050007001405002590780604084000053700500060825030900906001025,137246589258397146469158237371465892592783614684912753713529468825634971946871325,0.01398569997400045,43,105,62
257009008100400009049070060006003007030000801005004006501900604080540000674021093,257369418168452739349178265416283957732695841895714326521937684983546172674821593,0.04712750000180677,45,2065,2020
308027409100409008000080010200005807080900602003070145720603904930010700006700051,358127469162439578479586213214365897587941632693278145721653984935814726846792351,0.01291200000559911,42,45,3
453067090100200000079050060300004009090306204084020017921803000730600900006000030,453167892168239475279458163312784659597316284684925317921873546735641928846592731,0.01363689999561757,45,86,41
235107009140060207079080100000006002080590301002003064800004000920000000504901028,235147689148369257679285143351476892486592371792813564817624935923758416564931728,0.01514410000527278,45,145,100
207000039300204000069087000000008692500000703093020005010605028700010906806003071,247156839358294167169387254471538692582469713693721485914675328735812946826943571,0.01324830000521615,45,61,16
047009080100400007083760190306504009020100803000020051601005008932800600804070012,247319586169458237583762194316584729425197863798623451671235948932841675854976312,0.01322680001612753,42,49,7
246007083150000002009028100000004059400000600097060000804502096920600300760040021,246157983158396472379428165631784259482915637597263814814532796925671348763849521,0.02208210004027933,45,574,529
106035089300409001090060000000004008810000205005010040401028007650903000789040523,146235789327489651598167432263754198814396275975812346431528967652973814789641523,0.01494640001328662,44,162,118
368001579100809002500060008203008005480000900605023010000000006700900301956034080,368241579174859632529367148213498765487615923695723814831572496742986351956134287,0.01780780003173277,44,336,292
010050020090026005050009310020030078500800102080007034801002097700900850065083041,416358729397126485258479316124635978573894162689217534831542697742961853965783241,0.01503060001414269,43,199,156
147030080200109003060000000003597026570600001000010050631040098920003400004020065,147236589258179643369458172413597826572684931896312754631745298925863417784921365,0.01388180005596951,45,107,62
301000080207300004480150200000907500600510803508040000702435008930800400800020315,351274689267398154489156237123987546674512893598643721712435968935861472846729315,0.01376190001610667,43,87,44
207064050100009004060385002010090007300840005090702000901030070600000409045020831,237164958158279364469385712514693287372841695896752143921438576683517429745926831,0.01481149997562170,45,145,100
107008095200009007060000000401020006380906100690050430703000084820000609056084723,137468295248519367569237841471823956385946172692751438713692584824375619956184723,0.02433360001305118,43,746,703
106290048300008006080000000237004050800000160560000000605802093720041605048035710,156297348379418526482356971237164859894523167561789234615872493723941685948635712,0.08921780000673607,43,4454,4411
100036090058004007260007010401080070570301002090000300603000059720009800980073104,147236598358194267269857413431982675576341982892765341613428759724519836985673124,0.01326999999582767,44,68,24
040320580008009007300400602032090070000704006690200450900002060800900200700653198,146327589258169347379485612432596871581734926697218453913842765865971234724653198,0.01302479999139905,44,55,11
257060090061009008490300006020080030603094001980003700500070063800500900740900280,257168394361429578498357126124785639673294851985613742519872463832546917746931285,0.01352719997521490,44,82,38
340210060009057000570300104000070030250004001600000200004020386800706009900840752,348219567169457823572368194491572638253684971687193245714925386825736419936841752,0.01464860001578927,45,141,96
040326059008000007269507004070030020002001073600000500000050742900708600730260108,147326859358149267269587314471835926582691473693472581816953742924718635735264198,0.01436279999325052,44,123,79
046310080150000300300406007010060030900000005700000200501870690800601700600543810,246317589157289346398456127412765938963128475785934261531872694824691753679543812,0.03126190003240481,46,1087,1041
010340089008069002460208531030010060000902047704600200000030090900700000600894123,217345689358169472469278531532417968186952347794683215821536794943721856675894123,0.01296979998005554,43,56,13
060230489008009007400008003280050076600001002700600100002000630900810004540300891,165237489328149567479568213281453976694781352753692148812974635936815724547326891,0.01359950000187382,45,89,44
460037050070049020500068307210070860007000005849000200001950080900700100700320504,468237951173549628592168347215473869637892415849615273321954786954786132786321594,0.01312199997482821,44,73,29
030270810000040265500000007380050020007003008600800104712080000900001002860930501,436275819179348265528196347381459726247613958695827134712584693953761482864932571,0.01928339997539297,46,393,347
040360590000009306360005027080000960020093084703000010402006850800000431900810602,247361598158279346369485127584127963621593784793648215412736859876952431935814672,0.02582400001119822,43,752,709
250160390001009070408000106020080009603004001985603702009070060800500017740900205,257168394361429578498357126124785639673294851985613742519872463832546917746931285,0.01333099999465048,42,62,20
150247830000050260400000105830090700000072008267000901603920080005000093900730602,156247839379158264482369175834591726591672348267483951613924587725816493948735612,0.02994809998199344,43,951,908
060107405009040863003009002302000900080070016607003004000500608904000051850320709,268137495179245863543689172312456987485972316697813524721594638934768251856321749,0.01371109997853637,44,59,15
100006709200080145409007026610000507098670000004001038500000200000050060807403901,135246789276389145489517326612834597398675412754921638563198274941752863827463951,0.01411269995151088,45,104,59
130409078400370169209608003380700600000030000507000002800100920010000006905867001,136459278458372169279618543381724695692531784547986312863145927714293856925867431,0.01463719998719171,44,101,57
190274008400080009250096000603000702000030860809000035300805906700010080905607013,196274358437581629258396147613458792524739861879162435341825976762913584985647213,0.01558070001192391,43,203,160
140300002000410637009087014501800200000050009602074008910508000005030001806740905,147365892258419637369287514571893246483652179692174358914528763725936481836741925,0.01305459998548031,43,61,18
300106005108070620060050100602000009080790000705080014500000438006045791970803500,347126985158479623269358147612534879483791256795682314521967438836245791974813562,0.01487999997334555,43,120,77
200001009100090307360408020500700008090080000702004063620030904000027806805609231,247351689158296347369478125513762498496583712782914563621835974934127856875649231,0.01344110001809895,43,60,17
301200007460100500079000000120007806080510300007006014700000465900000081846701932,351248697468179523279365148123497856684512379597836214712983465935624781846751932,0.01353140000719577,43,64,21
008009367300200090470000082105004009700000500003007020000703908800920706690085030,258149367361278495479356182125634879746892513983517624512763948834921756697485231,0.03195099998265505,46,1137,1091
207100089600003204000280016100005008500600400006002030820907045004000820765020193,247156389618793254359284716172345968583619472496872531821937645934561827765428193,0.01420659996801987,43,136,93
365201089120300000070560032203000006050980001097020053500000008046000007782609014,365241789128397645479568132213754896654983271897126453531472968946815327782639514,0.01644620002480224,42,233,191
007002069100307000008000030401289006600034701590076020700603005000940600930050410,347812569159367248268495137471289356682534791593176824714623985825941673936758412,0.01337090000743046,44,66,22
300467009400009003500000470185006904290000700007910035720504008934020000056090040,312467589478159263569283471185376924293845716647912835721534698934628157856791342,0.01314160000765696,43,62,19
300126085108409003200050140010004809480701200005080010000000008830240700974800060,347126985158479623269358147612534879483791256795682314521967438836245791974813562,0.01291500002844259,43,60,17
408007359100005700050090140001000062580000400604072030000008004920040607846050010,468217359139465728257893146371584962582936471694172835713628594925341687846759213,0.01825910003390163,45,354,309
207038061100009402300120050000056829680400300003080040700002003920840600036000090,247538961158679432369124758471356829682491375593287146714962583925843617836715294,0.01323580002645031,44,49,5
201007689360100402000280153005000006730502804004060020000800007600900300890071045,251347689368159472479286153125498736736512894984763521512834967647925318893671245,0.01481399999465793,43,129,86
107008359200700006450100000302004005500872600004010070000905208820000704946080530,167428359238759416459136827372694185591872643684513972713945268825361794946287531,0.01388689997838810,43,84,41
006057091100400002000000004002003057300701408000040130001930005930070210857010043,246357891173489562589126374412893657395761428768245139621934785934578216857612943,0.01516320003429428,45,123,78
005026479200009008000500100302000001504600207978010030000437805750800300840050710,185326479237149568496578123362784951514693287978215634621437895759861342843952716,0.01481700001750141,43,107,64
056010030100009076000500200400005002502600780637020010703050064900700008860090320,256417839148239576379586241481375692592641783637928415713852964924763158865194327,0.01441090001026168,45,96,51
057060040300417569460300000003000000670000100095026000002070984700938001080042670,157269348328417569469385712213754896674893125895126437532671984746938251981542673,0.01375460001872852,44,75,31
307096048200107306000000501106000059580020000704060020601050004800619005970083610,317596248258147396469238571126374859583921467794865123631752984842619735975483612,0.01312799996230751,42,56,14
154030086000100009379400001001020605007600048690800000042000060700900503900760010,154239786268175439379486251481327695527691348693854172842513967716948523935762814,0.01395139994565398,46,88,42
054060010108009073300100204001070382003521907790480000005002000900700008030000100,254367819168249573379158264541976382683521947792483651415832796926715438837694125,0.01410900003975257,46,99,53
416030590257109004300400002172080935003090001000010006900003070500800000760920450,416238597257169384389457162172684935643795821895312746921543678534876219768921453,0.01370829995721579,43,73,30
240060170108000024570100603000040000006917005490800206000090057750000001084700360,243568179168379524579124683315246798826917435497835216631492857752683941984751362,0.01338120002765208,45,62,17
240069030000070059300400006710000890003000204900500370401050082580090043602830500,245169738168372459379485126714623895853917264926548371431756982587291643692834517,0.01497570000356063,44,162,118
016370580358000002470200601120050970007892004800700200000000020930008007700600403,216374589358169742479285631123456978567892314894713256641937825932548167785621493,0.01316299999598414,44,51,7
048050109079300005256700034700020500002100003590600000014000080805000006900800251,348256179179348625256719834761423598482195763593687412614532987825971346937864251,0.01335640001343563,46,61,15
040050900100049067209308001410007600503090004800403200600035049000000036905760802,347156928158249367269378451412587693573692184896413275621835749784921536935764812,0.01328809995902702,43,60,17
062370409358040000400506208090030840003087002780600500001000080905000001807900325,162378459358249176479516238296135847513487692784692513621753984935824761847961325,0.01330350001808256,43,54,11
063050408005103096208400003010540700007090002900702000020000847700000005809600321,163259478475183296298467153312546789547398612986712534621935847734821965859674321,0.01326769997831434,45,51,6
140250839058070000300408005010000090000004027000620400820005964004001002906800103,147256839258379641369418275412587396683194527795623418821735964534961782976842153,0.01432580000255257,45,109,64
160040830380169045402503006016000900008001024740800300020090013000030008603700402,165247839387169245492583176216354987538971624749826351824695713971432568653718492,0.01377289998345077,42,70,28
040350800350060007200008005410630509000094060806512304620000700000000002705126403,147359826358261947269478135412637589573894261896512374621943758934785612785126493,0.01300560001982376,43,46,3
040100706210060985009008003100600597495032010700500402630000800050040060804006009,348159726217463985569278143123684597495732618786591432631925874952847361874316259,0.01322250004159287,43,71,28
340206180150070020260008047510000000006037012703800065620000300000000001805043206,347256189158479623269318547512694738486537912793821465621985374934762851875143296,0.01331239996943623,44,62,18
210450609060070058507003004300080400002097815800600002100000000004020081900041203,213458679469172358587963124371285496642397815895614732126839547734526981958741263,0.01321960001951084,45,56,11
107280005000040060200007000470390600000001039003600004620000940734010080895704103,147286395358149762269537418472398651586471239913625874621853947734912586895764123,0.01576789998216555,45,191,146
257139006000060000309004105120450907506007030000300001000200000040080063805003402,257139846418562379369874125123456987586917234794328651631245798942781563875693412,0.01325940003152937,46,51,5
147006023050000706009000015602305008080710600095004030500900004004020080876003091,147586923258139746369247815612395478483712659795864132521978364934621587876453291,0.01290229998994619,44,46,2
352470009000090540409008001210357800003010072007804003720000900035040060800009205,352471689168293547479568321214357896583916472697824153721685934935142768846739215,0.01336600002832711,43,52,9
237100589150290060009000302300700000600030070795002003520600007070010820800027001,237146589158293764469578312312754698684931275795862143521689437973415826846327951,0.01683460001368076,44,240,196
103208009260000385008090000300402006520010803007000014700506900030049021906001037,153268479269174385478395162391482756524617893687953214712536948835749621946821537,0.01368790003471076,43,82,39
251000008060007200408000100100060902582030761607001050800400000700090013906513807,251349678369187245478256139134765982582934761697821354813472596725698413946513827,0.01484660001005977,43,161,118
100400893350000700009000025200500008070090406605000031500940680980050000700812049,127465893358129764469378125241536978873291456695784231512943687984657312736812549,0.01675340003566816,45,265,220
140508027000000009000029048413000002570094806906007003600803904030060000005402001,149538627258746139367129548413685792572394816986217453621853974734961285895472361,0.01341949997004122,45,65,20
247105068380070000009030047400000009070000500098000001810307006734650002065002473,247195368381476295659238147423561789176983524598724631812347956734659812965812473,0.01660380000248551,43,249,206
216009504058002009009060012102000705080000100007005003700600008043050000905021037,216379584358142679479568312132486795584793126697215843721634958843957261965821437,0.01403469999786466,46,101,55
300109802008000000000040060600007028700600900503800607420900703000081040067032591,346159872158276439279348165614597328782613954593824617421965783935781246867432591,0.01404410001123324,46,108,62
137508009280009500600023087306080094470306100008007002800904006740060000005000041,137548269284679513659123487316285794472396158598417632821954376743861925965732841,0.01309999998193234,43,61,18
147063059300501406050470100003045087700912300090007000001004600030000705000059230,147263859328591476659478123213645987785912364496837512571324698932186745864759231,0.01607170002534986,43,185,142
147030096268004007030080402325000068000000903000000004003000005750000049080056321,147235896268194537539687412325479168476821953891563274613942785752318649984756321,0.03115309996064752,46,1034,988
508016094100209006460080200004008009280000301006005408001000005850400107070650040,528316794137249586469587213314728659285964371796135428641872935852493167973651842,0.01387239998439327,45,94,49
065037049400209003080450200003098002700310900090025030500903084930800700000060090,265137849471289563389456217153698472728314956694725138512973684936841725847562391,0.02032169996527955,44,424,380
207050068108009004360040100402003097500104823000000401000006009600900702080470310,247351968158769234369248175412583697576194823893627451721836549634915782985472316,0.01886379998177290,44,370,326
146005097200009603380060500403072089500608400090010006005003904920700008030040070,146235897257189643389467521463572189571698432892314756715823964924756318638941275,0.01368080003885552,43,91,48
216475093300269007470030200002007086500600700600004350000000008820510000930080010,216475893358269147479138265142357986583691724697824351761942538824513679935786412,0.01297039998462424,44,61,17
147003086300001702060580400001605029600700305000000001700000238920300104000040950,147293586358461792269587413471635829682719345593824671714956238925378164836142957,0.01632809999864548,45,240,195
200305098300006004460170300002009006500200809080060721000704003700801205090630010,217345698358926174469178352172489536536217849984563721621754983743891265895632417,0.01296220003860071,44,57,13
040050069208001004060740100402030098900100502000020017001004053590200806800970021,147358269258691734369742185412537698973186542685429317721864953594213876836975421,0.01351770001929253,43,105,62
240351089100209003080070100008007024400190506000600010500002007900710845804060030,246351789157289463389476152618537924423198576795624318531842697962713845874965231,0.01261400000657886,43,44,1
053407029200058007070030006014000002600900403080020000001002070700800605860710034,153467829296158347478239156314586792625971483987324561531642978742893615869715234,0.02013169997371733,46,439,393
120340970007090040400207008040970800500003017000602009010030000906001584200804301,128346975357198246469257138641975823592483617783612459814539762936721584275864391,0.01613740000175312,44,221,177
316000470402080030500300002130000000007000000894500007620930004700002053903408601,316259478472186539589347162135724896267891345894563217621935784748612953953478621,0.01476430002367124,46,137,91
100230908008060030300815006410370500805090060960020104020003095000001607700650410,146237958258469731397815246412376589875194362963528174621743895534981627789652413,0.01413510000566021,42,100,58
246350790007090380308100005460070809002009040900000007610000070705004012829706003,246358791157692384398147265461275839572839146983461527614523978735984612829716453,0.02334650000557303,42,597,555
290400300000560090308279000010080900625004080809000005460000070502001006980706401,296418357147563298358279614714385962625194783839627145461832579572941836983756421,0.01327249995665625,45,53,8
200300409008029050409508026310600008600050032700000001070000004803040005540712003,257361489168429357439578126312694578684157932795283641971835264823946715546712893,0.01374170003691688,45,61,16
100450709068097030509803064730000090000080010800000002010530608000064001206918503,123456789468197235579823164731245896652389417894671352917532648385764921246918573,0.01474029995733872,43,138,95
200308609060149080300007005430080700001402030900713002020030000009025006853601904,214358679567149283398267145432586791671492538985713462126934857749825316853671924,0.01389100000960752,42,56,14
230600509006080230009005186090800000000090063700000001010000908025010074947568302,238671549156489237479235186391846725582197463764352891613724958825913674947568312,0.04727889999048784,44,1938,1894
270140908016090040409000006000905802007000060600703004060500400002000081703809625,275146938316298547489357216134965872527481369698723154861572493952634781743819625,0.01410510001005605,45,112,67
240371500100040070309000001400780906003000000500106002821000700064000015705604208,246371589158249673379568421412785936683492157597136842821953764964827315735614298,0.01449990004766732,45,118,73
160205009270060580009000006300400008000090700790003002820000947030000065607904203,168245379273169584549378126312457698485692731796813452821536947934721865657984213,0.06476400000974536,46,2888,2842
340170600070090020209300007500780903094060000803005204420000800038000051651009702,345172689176498325289356147512784963794263518863915274427531896938627451651849732,0.01341429998865351,43,57,14
130260500250070000409508073310607804070020000800005002920000600003000025685002107,137264589258379461469518273312697854574821396896435712921753648743186925685942137,0.01340399996843189,44,71,27
240130509050060020109007040502800601000010782800002004000000805730000016905001073,247138569358469127169257348572894631493516782816372954621743895734985216985621473,0.03905860002851114,45,1558,1513
237500109008760040409000005300250008690084030500007006710020900000071023020003701,237548169158769342469312875371256498692184537584937216713625984945871623826493751,0.01357309997547418,44,86,42
106370900200190300309206050510600703800050010900004005420030500008000071700001832,146375928257198346389246157514682793872953614963714285421837569638529471795461832,0.01378730003489181,44,76,32
150200406439080000008000000300008009006097241790461005000840600200005018805003904,157239486439186572628754193341528769586397241792461835913842657264975318875613924,0.01385499996831641,44,68,24
200450809000260700000008105310500007000090000704003006920700608640900070805612093,237451869158269734469378125312546987586197342794823516921734658643985271875612493,0.01543359999777749,45,184,139
154260700060040805000007040400006008000080300986003012610800207030020081042001053,154268739367149825298357146423516978571982364986473512615834297739625481842791653,0.02666209999006242,44,781,737
130400208400300100000001037300004509080090060604005002910700005020006800806053971,137469258458372196269581437371624589582197364694835712913748625725916843846253971,0.01807220000773668,45,354,309
400900368360140907000000045100003006650000470007006032500600000002031650906704213,415927368368145927279368145124573896653289471897416532531692784742831659986754213,0.01454130001366138,43,153,110
240301009150090304000050070601000008480000050093002017906800005734520000805719043,247361589158297364369458172671945238482173956593682417916834725734526891825719643,0.01313229999504983,42,68,26
205607309160035200000000060400000008090180007003094012500709803820040500936052041,245617389168935274379428165451276938692183457783594612514769823827341596936852741,0.01322180003626272,42,71,29
200156809100409000060030051300907005574200600000805037700580900000604003006070582,237156849158429376469738251381967425574213698692845137713582964825694713946371582,0.01393620000453666,43,104,61
325008179160200400009000030800005004530690820006004051600970000048010060903046012,325468179167239485489157236871325694534691827296784351612973548748512963953846712,0.01339959999313578,42,44,2
400728003130009276000000085310000009082000500007064012500000900743900008806540700,465728193138459276279136485314275869682391547957864312521687934743912658896543721,0.01333589997375384,45,58,13
102308009350070140790004050400000807560080090907000001200900706030010020609005014,142358679356279148798164253421596837563781492987432561215943786834617925679825314,0.01908930001081899,45,383,338
306209801120400500000050030203000005074090308905360004701908006060000903009035012,356279841127483569498156237213847695674591328985362174731928456562714983849635712,0.01294450002023950,43,70,27
107589042200400109000030050070001006000090200602070013800900407020040090006013025,137589642258467139469132758374251986581396274692874513813925467725648391946713825,0.01251939998473972,46,49,3
402761309300209407000340260200030078800900001507000032000000004040015706005002093,452761389368259417179348265214536978836927541597184632721693854943815726685472193,0.01679889997467399,44,241,197
107459082200100409009080030500028064380500207602300010003700006720090003006000020,137459682258163479469287135571928364384516297692374518813742956725691843946835721,0.01444840000476688,44,128,84
465000092100200300080060075300507009000890204008000037590400703720900800006050041,465378192179245368283169475342517689657893214918624537591486723724931856836752941,0.01408260001335293,45,111,66
106047093307109200400060500010002009620010475009086021800704006070000130065000042,156247893387159264492368517513472689628913475749586321831724956274695138965831742,0.01280759996734560,42,44,2
137048069200600013009070084305002007000506000800000050601804005750000000004065321,137248569248659713569173284315482697472596138896317452621834975753921846984765321,0.01674719998845831,45,264,219
105234089308100000470060000200456078600000000090300015500603007730000001006010042,165234789328197456479568123213456978657981234894372615541623897732849561986715342,0.01738520001526922,46,302,256
027050069408100003060040108203005007070800904000020030601002005740500300085030710,127358469458169273369247158213495687576813924894726531631972845742581396985634712,0.01310999999986961,45,56,11
316009028209100407000050300501007084090004706060090000000005009640900800087043150,316479528259138467478256391521367984893524716764891235132785649645912873987643152,0.01363020000280812,45,89,44
108004070300500008070010200206409007040001906007060410600003025000650300835042060,158234679362597148479816253216489537543721986987365412694173825721658394835942761,0.01552800001809373,45,180,135
154000986268100007079080250401309075000600803630010000700002009800000700020040030,154237986268195347379486251481329675592674813637518492743852169815963724926741538,0.01495109999086708,45,146,101
206074050300000006480020070620908540105063200090052630000005082040000700568090310,216374859357189426489526173623918547175463298894752631731645982942831765568297314,0.01289880002150312,43,43,0
107068092208000107430070500002004059500002006000030000000803975900500600740026810,157368492268459137439271568312684759574192386896735241621843975983517624745926813,0.01579149998724461,45,191,146
058000697400002005000000102024005069380007501090020030700003906940500200065010073,258134697471962385639758142124385769386497521597621834712843956943576218865219473,0.03078670002287254,45,1178,1133
205000019100009007300040500003002076590407003021063000000004758900700620057021934,245376819168259347379148562483592176596417283721863495612934758934785621857621934,0.01330099999904633,43,66,23
041050760500069003009400500006090070200000005050000300003806954920730100865041230,341258769572169843689473521136592478297384615458617392713826954924735186865941237,0.01435720000881702,44,134,90
158030090409107003273400000000070080500902001690000500005001039800600700946050810,158236497469187253273495168312574986584962371697318524725841639831629745946753812,0.01347910001641139,45,59,14
056010040170009006000400102002080097760105008900000600001006074600900205849050361,256318749174529836398467152412683597763195428985274613521836974637941285849752361,0.01317429996561259,44,60,16
105360090200009005080200006003090080701408003090010500007004038900500407634070259,145367892276189345389245176453692781761458923892713564517924638928536417634871259,0.01388760004192591,44,53,9
045061080108009005370200000012040090700603002800010600001006073900100804586030920,245361789168479235379258416612547398794683152853912647421896573937125864586734921,0.01325489999726415,44,48,4
207040060008309057400600002000060080500803001890010600001004735900700800085036190,237145968168329457459678312312467589576893241894512673621984735943751826785236194,0.01355759997386485,45,77,32
038040070509007008100500306012050090400901002090080405001002083700800000846030251,238146579569327148174598326312654897485971632697283415951462783723815964846739251,0.01341439998941496,44,63,19
058340070209008045400200006010890050507000038980500102002005091600700000740080600,158346279269178345473259816316892457527614938984537162832465791691723584745981623,0.01473499997518957,45,124,79
138057060002008003000304100001080090200906004090040802003005046900600007850070231,138257469462198753579364128341782695285916374697543812713825946924631587856479231,0.01588690001517534,45,180,135
126048750308009006409500300040080090500007063000000200007004035900700002865030401,126348759358279146479516328642183597591427863783695214217864935934751682865932471,0.03972190001513809,45,1532,1487
157240098368107005400300007013080000500001004890000000001060089940000501680400703,157246398368197245429358617213784956576921834894635172731562489942873561685419723,0.01788549998309463,44,324,280
207060039050003046300408000070032900600004075490000208014020007905007003706500492,247165839158293746369478521571832964682914375493756218814329657925647183736581492,0.01345519995084032,43,82,39
137040589208130060400507003000070600000001008790000000003052004904703806870960301,137246589258139467469587213381475692542691738796328145613852974924713856875964321,0.01585979998344555,43,231,188
137050480200030060500407001400070800006008014900620705003040072702903008800000103,137256489248139567569487321425371896376598214981624735613845972752913648894762153,0.01281449996167794,44,45,1
247056080100009060300187400000060800005008003890700500001073048603402001900005206,247356189158249367369187425732561894415928673896734512521673948683492751974815236,0.01417099998798221,44,84,40
457310620000005040100247000070080500000001076090000802002034005905102084800709200,457318629328695147169247358271486593583921476694573812712834965935162784846759231,0.02008220000425354,45,420,375
240061870100009042300200600050670020700004006000000714517026083608400007900708200,245361879176859342389247651451673928792184536863592714517926483628435197934718265,0.01597539999056607,43,189,146
215040780400007320309200005080020000002501008000800602001082003926004001807900200,215349786468157329379268145183426597692571438754893612541682973926734851837915264,0.01340900000650436,45,74,29
130428560200069030400307008010000000700001005090600204001000053502904601900510740,137428569258169437469357128314295876726841395895673214641782953572934681983516742,0.01545249996706843,44,194,150
138050970260008030400200006040060000002091003000300001010007004927005008604810720,138456972269178435475239186341562897582791643796384251813927564927645318654813729,0.01380509999580681,46,74,28
130480250200090040460205008010000005500021063000308104000009032903014006640702801,137486259258193647469275318312647985584921763796358124871569432923814576645732891,0.01278569997521117,42,44,2
130250680208000040400600007320040800001096004600002703070010900003005472940807500,137254689268179345459638127325741896781396254694582713572413968813965472946827531,0.01320049999048933,44,56,12
210300500000000040400170006720091604065000719100706803030080400008002075600504901,216348597357269148489175236723891654865423719194756823531987462948612375672534981,0.01311309996526688,44,48,4
217060300400039000300002005020007500004010732790306014531600900042800003800203000,217568349458139267369742185123487596684915732795326814531674928942851673876293451,0.01513110002269968,44,166,122
150200708008000000309508002410300870007000023600402001060000004924005037830746009,156234798248197365379568142412359876597681423683472951761923584924815637835746219,0.01345950004179031,44,57,13
230140605108060000400207003014870000602003018900600302020030009806001007790405260,237148695158369724469257183314872956672593418985614372521736849846921537793485261,0.01300099998479709,42,50,8
200560390108370020300004001070090004402000057600400012810020065025000003730805009,247561398158379426369284571571692834492138657683457912814923765925746183736815249,0.01344690000405535,44,75,31
320001580100069040400500006540000800003000465690805031710030954064000008800104002,326471589158269743479583126541326897283917465697845231712638954964752318835194672,0.01353780005592853,43,82,39
140270380000054000300006045480007009001060834600940012010020008026000003807405001,145279386268354197379816245482137569791562834653948712514623978926781453837495621,0.01322700001765043,44,69,25
306109400200400090400085600060300900503017000704008001820500700037042019905700860,356179428278463195419285673162354987583917246794628351821596734637842519945731862,0.01635689998511225,43,241,198
120954000008073050500206004390000000004010035600307902710030690806000003950860041,127954386468173259539286174391528467274619835685347912712435698846791523953862741,0.01382940000621602,43,98,55
357400108160200900200008350410300069000000080800004003620040700004051030705906804,357469128168235947249178356412387569573692481896514273621843795984751632735926814,0.01505890005500987,44,141,97
250100093310000400400008002020600500794020010500001004630080709042003001905400208,257164893318297465469358172123649587794825316586731924631582749842973651975416238,0.04214099998353049,45,1701,1656
156300209020050060308006054500080003080010046000005701030020890842000035900000012,156348279427159368398276154514687923783912546269435781631524897842791635975863412,0.01622390002012253,45,217,172
100250039250009070300007054510003402070010680000405007020508703034000008700030921,147256839258349176369187254516873492473912685892465317621598743934721568785634921,0.01396669994574040,43,95,52
200357009600000208049000000400010000080426001100803004700600902024030070965742813,218357469657194238349268157472519386583426791196873524731685942824931675965742813,0.01386200002161786,43,87,44
200389406069020018408007020100008004590070000004001003020040900005016240906702801,217389456369425718458167329172538694593674182684291573721843965835916247946752831,0.01345899997977540,43,75,32
100438509208009000009000800400512000580090000002004003800007200005041030906025714,167438529248159367359276841473512986581693472692784153814367295725941638936825714,0.01356420002412051,46,57,11
100268059200300000400071030300002905590080760804009001700400603023000040905830207,137268459258394176469571832316742985592183764874659321781425693623917548945836217,0.01414719998138025,43,139,96
530107409064000080200400030300005906420090050805004003000930805002076010003501692,538127469164359287279468531317285946426793158895614723641932875952876314783541692,0.01288870000280440,43,61,18
106208000040190000309060018400706809580000670007005001810400900024070085705000342,156238794248197536379564218431726859582941673697385421813452967924673185765819342,0.01896180002950132,43,376,333
140207008058060000300000060500302609490070010703001025600080200905010080837605941,146237598258169734379458162581342679492576813763891425614983257925714386837625941,0.01299890002701432,42,49,7
304628009100009800009000600500306000010290706006004035400003508035080017708500362,354628179167459823289137654542376981813295746976814235421763598635982417798541362,0.01719949999824166,43,276,233
205407098060230400079080021302004000690000140004001006520700800043060019006000273,235417698168239457479586321312674985697358142854921736521793864743862519986145273,0.01521990000037476,43,172,129
205109007100307504000080310300002000680900705004000061506203478900070050007001923,235149687168327594479586312351762849682914735794835261516293478923478156847651923,0.01390419999370351,43,93,50
247503019108200006060070002400002008580000030003007021900600007725090063006000045,247563819158249376369178452471352698582916734693487521914635287725894163836721945,0.01373449998209253,45,78,33
207409068100360709060080000305000006720630890806000032940800007002000900003005014,237419568158362749469587321315298476724631895896754132941823657572146983683975214,0.01563929999247193,45,174,129
759104002100300609000050000203407006460000000007003428600705004900020760075046013,759164832142378659386259147213487596468592371597613428621735984934821765875946213,0.02019419998396188,44,455,411
456203001107400203020090000201009007980070400004000039600700045709050020045020076,456283791197465283328197564261349857983576412574812639612738945739654128845921376,0.01433070003986359,44,109,65
207050089140200305080090002000004008470980200000007061500600007720000900968000514,237451689149268375685793142356124798471986253892537461513649827724815936968372514,0.01419570000143722,46,109,63
247006085100409600000070020000007008680010400003005210800903701500260009034081060,247136985158429673369578124412697358685312497793845216826953741571264839934781562,0.01368649996584281,45,72,27
217406009400109700000070000005607008180000203004003010600802307850700004073060182,217456839438129765569378421325617948186945273794283516641892357852731694973564182,0.01451799995265901,44,119,75
237000085158200900009050000500006002380020060000005014700900406920010300846003290,237149685158267943469358127571496832384721569692835714713982456925614378846573291,0.01367850002134219,45,85,40
148209065207300409000040010501603004420050900703000150800905007630000500000010023,148279365257361489369548712581693274426157938793824156812935647634782591975416823,0.01395809999667108,44,124,80
105068047700401002240057610017039086002004105000000004000805073850900401000010020,195268347736491852248357619417539286362784195589126734621845973853972461974613528,0.01859559997683391,43,387,344
327100089100209006000070020200007004000904302004000761901005048870400905045090010,327146589158239476469578123213657894786914352594382761931725648872461935645893217,0.01541669998550788,44,202,158
207010089100509003050020140002065008000008302080070005001806907760900820000032651,237614589146589273958327146312465798475198362689273415521846937763951824894732651,0.01852560002589598,43,380,337
403058096100309008080060130004036085390502407060000001600905002940600700000023019,473158296126349578589267134214736985398512467765894321631975842942681753857423619,0.01408489997265860,42,131,89
201009687300100009000060010103046098480200300007000004900604005850720900000035042,241359687368172459579468213123546798485297361697813524932684175854721936716935842,0.01523229997837916,45,140,95
317006089500109604060070000104002008200300400090080021001823005950600800003050216,317246589528139674469578132134762958285391467796485321641823795952617843873954216,0.01311699999496341,43,55,12
346109078100200009098060000603700004700500860085003002000802096530000400800070021,346159278157284639298367145613728954724591863985643712471832596532916487869475321,0.01438740000594407,45,127,82
302400719100203008080150002007000006634700090005010000001024003920000800700039520,352468719176293458489157632217945386634782195895316247561824973923571864748639521,0.01457850000588223,46,128,82
345210709000009000270040063400620097006000200790004000800950006007400832604083001,345216789168379524279548163481625397536197248792834615813952476957461832624783951,0.01451529999030754,44,122,78
125348607300000000090200050200010809004000300850003001500890002002500906903026008,125348697376159284498267153237415869614982375859673421561894732782531946943726518,0.02848119998816401,46,931,885
145367209000009000070050063700590046002000900690014002500920007006700504807035001,145367289368249175279158463781592346452673918693814752514926837936781524827435691,0.01550610002595931,43,175,132
305400789260089000400050061106000890890070506570008000630000004700000052052006300,315462789267189435489357261126534897893271546574698123631825974748913652952746318,0.01337330002570525,45,65,20
315248609000070000089000020100020803003004000890013002500460087008700206602085001,315248679426179538789356124154627893263894715897513462531462987948731256672985341,0.02114369999617338,44,484,440
356248709200000000080000050400020078028000100790013004500690041001500207802031005,356248719274159386189367452413926578628475193795813624537692841961584237842731965,0.01919130003079772,44,435,391
017460392208130067069000800120080006700090000050301008601040009090003005870016004,517468392248139567369257841123784956784695123956321478631542789492873615875916234,0.01341919996775687,43,73,30
100540092050000030209000405600093000000007008500810064021900603803005009965021807,136548792458279136279136485682493571314657928597812364721984653843765219965321847,0.01429259998258203,44,125,81
307190064010000070209000105100000000000007002804630009030700406740009001986041327,357198264418256973269473185175924638693817542824635719531782496742369851986541327,0.02620010002283379,45,773,728
200430089060000040409000301100370000000004002800060007010003900940718006785692413,251437689368129745479856321126375894537984162894261537612543978943718256785692413,0.01460639998549595,44,131,87
200430089060000040409000301100370000000004002800060007010003900940718006785692413,251437689368129745479856321126375894537984162894261537612543978943718256785692413,0.01444910001009703,44,131,87
200460078076000050409000002100090000000001004500030607060003800810026005945718236,251469378376182459489375162124697583637851924598234617762543891813926745945718236,0.01847459998680279,45,350,305
300760082068200050209000006500070000000805003700090001010006200920037005837521964,354769182168243759279158346541372698692815473783694521415986237926437815837521964,0.01846960000693798,44,358,314
008007369000000208025009700210073805400590031090800400000008006750640003860035027,148257369379164258625389714216473895487592631593816472931728546752641983864935127,0.01270929997554049,43,44,1
008000914100000703073009600340072005500930076090500200000003007926010008730046029,258367914169428753473159682341672895582931476697584231814293567926715348735846129,0.01386080001248047,44,80,36
008300014000400703073009000340070005500901076007500200004003500920010008730846029,258367914169428753473159682341672895582931476697584231814293567926715348735846129,0.01379749999614432,45,58,13
100260089058000460300000005500000006000703012002010503020007600430028007976541238,147265389258379461369184725513492876684753912792816543821937654435628197976541238,0.01611409999895841,43,213,170
007008569001000208089006300350087006100690035090500700000004003920860007640735021,237148569461359278589276314352487196174692835896513742715924683923861457648735921,0.01307769998675212,42,42,0
400360027069000840500000009300007000080006035000020781030004900840091002957832614,418369527269175843573248169321587496784916235695423781132654978846791352957832614,0.01442000002134591,43,124,81
100006047009500328273009100310092004507040003000300090000008405740050000980174032,158236947469517328273489156316792584597841263824365791631928475742653819985174632,0.01314080000156537,43,50,7
201000078306100450489005100100097083000800024000000610700003800810026005940718036,251469378376182459489375162124697583637851924598234617762543891813926745945718236,0.01755240000784397,42,304,262
200000658008100490460000700500001004600450037000830520003005100840013009170289045,217394658358167492469528713532971864681452937794836521923745186845613279176289345,0.01324909995310009,43,62,19
100000925008409360360000100400008006500690013000700850004003600920067001730142089,147386925258419367369275148471538296582694713693721854814953672925867431736142589,0.01363919995492324,43,88,45
300000816008400390560000700200008007400320058000700120000005200730014009950872031,347259816128467395569183742213598467476321958895746123681935274732614589954872631,0.01386609999462962,45,107,62
300000816008400390560000700200008007400320058000700120000005200730014009950872031,347259816128467395569183742213598467476321958895746123681935274732614589954872631,0.01407759997528046,45,107,62
100320096000100080009000105503004900420073001000210438002006800050002000964031207,145328796276159384389467125513684972428973561697215438732546819851792643964831257,0.01586949999909848,45,230,185
300490078000300090009000106203004500680059003000830614001005900040006000965013802,356491278128367495479528136213674589684159723597832614831245967742986351965713842,0.02813759999116883,45,995,950
400230069000100040000000201105002400290056003300490825001004900040005000856023704,418237569529168347673549281185372496294856173367491825731684952942715638856923714,0.02647550002438948,45,898,853
150248069008160457409000200070005000500010006000800035002000800935001000840720091,157248369328169457469357218271635984583914726694872135712596843935481672846723591,0.01511639996897429,45,153,108
300490078100300090009000136203004500680059003000830614001005900040006000965013802,356491278128367495479528136213674589684159723597832614831245967742986351965713842,0.01657239999622107,43,272,229
150936048002100597409000300010004000700080002000310076001400700973005600840760023,157936248362148597489257361216574839734689152598312476621493785973825614845761923,0.01306469994597137,43,47,4
230458096108000047409000000070206000600090001000370082003700800725003400840900023,237458196158639247469127538371286954682594371594371682913742865725863419846915723,0.01574679999612272,45,189,144
340125089007000026209400000060003000800010003000580071005700900928001300730800612,346125789157398426289467135561273894872914563493586271615732948928641357734859612,0.01411260000895709,45,92,47
250163079009050021401200000020006000700090006000510032003700600947001250682900317,258163479369457821471289563124376985735892146896514732513728694947631258682945317,0.01281679997919127,42,49,7
150349076009000035203000000012007000500090003000280041001900600735001400946800312,158349276469712835273568194312457968584196723697283541821934657735621489946875312,0.01469310000538826,44,122,78
450136098100000047200800000001002000580060004000780021005600900923000400846300750,457136298138295647269847135371452869582961374694783521715624983923578416846319752,0.01399440004024655,46,94,48
360140059400000078000200310106002800280091003700860042001900407040000000857004900,368147259412359678579286314136472895284591763795863142621935487943718526857624931,0.01402630005031824,45,116,71
230458091100000048409300020061004900570031004800000032008000470023009800945000203,236458791157692348489317526361284957572931684894765132618523479723149865945876213,0.01557009998941794,43,186,143
340510892100039007000400030001005900580064003700120046004700089007000601835001200,346517892158239467279486135461375928582964713793128546614752389927843651835691274,0.01323300000512972,43,57,14
130467298200089001000100060001006800372091400900500030000700005000000613059003700,135467298267389541498125367541236879372891456986574132613742985724958613859613724,0.02103140001418069,46,461,415
260458379300069008400200050006004700530086000700500020000800004007940502024005800,261458379375169248489237156196324785532786491748591623653872914817943562924615837,0.01406319998204708,45,79,34
210347089300089006400250030001602700670094000980500020000900005005010900039005400,216347589357189246498256137541632798672894351983571624164923875725418963839765412,0.01393499999539927,45,79,34
210368094400029006300450020002805400580046000600700080000670003006000207045003600,217368594458129736369457821172835469583946172694712385821674953936581247745293618,0.01408420002553612,45,106,61
350641089160079005400380060004803500590017000700902010000500008007020406045006200,352641789168279345479385162214863597596417823783952614621534978937128456845796231,0.01450360001763329,43,131,88
140238096200096007300450082002803900580042000600501020000600009005000608036009450,147238596258196347369457182472863915581942763693571824714685239925314678836729451,0.01331529999151826,43,58,15
546038297100740056000500480203007800480001000690000504000000945002800670760095100,546138297128749356379526481213457869485961732697283514831672945952814673764395128,0.01320340001257136,42,52,10
154078269200150084000400750403005800670001000890000002500040970006800520730092100,154378269267159384389426751413265897672981435895734612521643978946817523738592146,0.01318599999649450,42,45,3
154078269200150084000400750403005800670001000890000002500040970006800520730092100,154378269267159384389426751413265897672981435895734612521643978946817523738592146,0.01303810003446415,42,45,3
451037608600150043000400070507000400160002500290000006700020060005800730840013900,451237698679158243382469175537681429164392587298574316713925864925846731846713952,0.04111370001919568,45,1688,1643
241036709300190054000270063405000600120003000790000005600080040053700820870029000,241536789367198254589274163435817692126953478798462315612385947953741826874629531,0.01346019998891279,44,79,35
345017609100380045000400017401000800760008000900050002500830060024900530839046000,345217689176389245298465317451723896762198453983654172517832964624971538839546721,0.01447509997524321,43,124,81
137086209200190047000500038306000905720009000800070004500930080002700510670015400,137486259258193647469527138316248975724359861895671324541932786982764513673815492,0.01334880001377314,43,62,19
261048509300169028000200031102000700690007000700010003500890067006700850830026000,261348579375169428489275631142953786693487215758612943524891367916734852837526194,0.02154300000984222,43,543,500
256137849300040002400200530005003400600018000000400750001700026002000380060052000,256137849397845612418269537125973468674518293983426751531784926742691385869352174,0.05211560003226623,46,2262,2216
256137849300040002400200530000003400600018003000400750501780026002000380860052070,256137849397845612418269537125973468674518293983426751531784926742691385869352174,0.02490399999078363,42,756,714
256137849300040002400200530000003400600018003000400750501780026002000380860052070,256137849397845612418269537125973468674518293983426751531784926742691385869352174,0.02534839999862015,42,756,714
256137849300040002400200530000003400600018003000400750501780026002000380860052070,256137849397845612418269537125973468674518293983426751531784926742691385869352174,0.02507070003775880,42,756,714
260370058400100030509000107120507006380600004600810003002700860043000000756081002,261379458478125639539468127124537986387692514695814273912743865843256791756981342,0.01461469999048859,43,136,93
400350829200100050560008100100005008000800002786020001600000937052000080870064005,417356829238149756569278143124695378395817462786423591641582937952731684873964215,0.01361090003047138,46,91,45
200340067300100090400008105500704008000800006807020304000900540643001000985032001,251349867368157492479268135536714928124893756897625314712986543643571289985432671,0.01477140001952648,45,173,128
201340769300200004409100350120007006600090021000600830702080005030001070840025010,251348769367259184489176352128537496673894521594612837712983645935461278846725913,0.01336199999786913,43,60,17
100320098208100050300000102400603000000200001702080003010800970927016005834759016,145327698268194357379568142481673529693245781752981463516832974927416835834759216,0.01339639996876940,42,58,16
000100095107200360280000701500398006000600003803010007010800500720060004938754012,346187295157249368289536741571398426492675183863412957614823579725961834938754612,0.01410219998797402,43,81,38
200130589100200360360008000400020005000900072090070403600750948020001050780060031,247136589158297364369548127471823695536914872892675413613752948924381756785469231,0.01392570004099980,44,84,40
100240067403000900270000004300580006006400031704013008020800540830054000045700183,158249367463178925279365814312587496586492731794613258627831549831954672945726183,0.01495459995931014,43,147,104
200410089108300700460008021300100004000200015805090007020700690780061002046800173,237416589158329746469578321372185964694237815815694237521743698783961452946852173,0.01365619996795431,42,80,38
100360289300000100260008000400000006002900730093080002910450328820031070030800041,147365289358249167269178453471523896582916734693784512916457328824631975735892641,0.02952649997314438,44,996,952
100450792207100300480007000300040009000900031094010006920870653540091080060300014,136458792257169348489237165312546879675982431894713526921874653543691287768325914,0.01331469998694956,42,54,12
001500980270000506605100070420015009000200065039000700810034007900670048760852003,341567982278349516695128374426715839187293465539486721812934657953671248764852193,0.01359460002277046,42,77,35
100040079207003600400067003000600097062000300970081004000730986040005000080900451,136248579257193648498567123314652897862479315975381264521734986649815732783926451,0.01326370000606403,46,56,10
100040079207003600400067003000600097062000300970081004000730986040005000080900451,136248579257193648498567123314652897862479315975381264521734986649815732783926451,0.01311240001814440,46,56,10
100040079207003600400067003000600097062000300970081004000730986040005000080900451,136248579257193648498567123314652897862479315975381264521734986649815732783926451,0.01324299996485934,46,56,10
056309280470052009009400057310007000000000708907040000620900005003800692895006403,156379284478152369239468157312587946564291738987643521621934875743815692895726413,0.01432550000026822,43,117,74
250068094401000508300057021004500769036004000980010002000800947040901000070600153,257168394461329578398457621124583769736294815985716432612835947543971286879642153,0.01410510001005605,42,101,59
250068049308000205400002080002005608583001000690080003001900804035004000040800071,257168349368479215419532786172345698583691427694287153721956834835714962946823571,0.02263890003086999,45,574,529
057108390460029008008400021120003700030094005005010002610800040000000206879002103,257168394461329578398457621124583769736294815985716432612835947543971286879642153,0.01334539998788387,43,44,1
157308290260059007009200058370004900080002005502070001810900070000000503745006109,157368294268459317439217658371584962684192735592673841813925476926741583745836129,0.01363689999561757,42,80,38
208370950150008070003500028310005800080092003004080002820900000007006009946007201,268371954159428376473569128312645897785192643694783512821934765537216489946857231,0.01294059999054298,44,64,20
205196387100008059009400610431005800650000004008010003510700060024000705870009001,245196387167328459389457612431275896652983174798614523513742968924861735876539241,0.01588220003759488,42,219,177
268371954100008076003000120310005800780090003004000002820000060037000409946007001,268371954159428376473569128312645897785192643694783512821934765537216489946857231,0.01959720003651455,43,424,381
250067089108000275309008000000003008603080004840600010001000697036004802080726031,254167389168349275379258146512473968693581724847692513421835697736914852985726431,0.01406690001022071,42,141,99
247358691100009073009000400430005000800690004006800020610000780024001906985006002,247358691158469273369127458431275869872693514596814327613942785724581936985736142,0.01326880004489794,42,68,26
108300429360000007000020136203700900680109200000800014520047600900000000047600090,158376429362491857479528136213754968684139275795862314521947683936285741847613592,0.01250710000749677,46,61,15
207400681148000000500000043305600100480300000000800074710008402900720006026500910,237459681148236795569187243375694128481372569692815374713968452954721836826543917,0.01468349999049678,45,128,83
106509284250004000400000071301000400570400000000600032610005807700000049049700360,136579284257184693498326571361297458572438916984651732613945827725863149849712365,0.02221409999765456,46,568,522
